(AWS)	Afrikaanse Woordelys en Spelreëls
(bvh)	Bosman, Van der Merwe en Hiemstra
(clc)	Coetzee, Du Plooy en Cluver
(cmdp)	Combrink, Meyer en Du Plooy
(sitting, standing) straight up	(sit, staan) penorent. penregop
(tbt)	Terblanche se Tegniese woordeboek
16-bit	16-bis
32-bit	32-bis
5-speed manual	5-spoed-hand (ratte)
a	'n
a capella choir	a capella-koor
a few, any, some	enige, enkele, sommige
a little, some, to some extend, rather, enough	nogal
a little, some, to some extend, rather, fairly	taamlik
a long time, for a long time	geruime tyd
a long time, for a long time	lank
a lot of, much, many, quite, very, very much	baie
a, any, anybody, some, somebody, someone	enigiemand, iemand
a, in, inside, into, per, within	binne, in
a, in, inside, into, per, within, by, by means of	per
a, in, inside, into, per, within, on, upon	op
a-bomb	a-bom
a-framed house	a-raamhuis
a4-size	a4-grootte
aardwolf	aardwolf
aaronic priesthood (authority)	aäronitiese priesterskap
aaronic priesthood (bearers of)	aäronitiese priesterorde
abacus	abakus
abalone	perlemoen
abalone shell	perlemoenskulp
abandon, forsake, desert, leave	verlaat
abandoned, nasty	immoreel
abase	verneder
abasement	verlaging
abashment, shame	skaamte
abate, abridge, decrease, lessen, diminish, drop	verminder
abatement, discount, rebate	afslag
abattoir, slaughterhouse	abattoir
abbess	abdis
abbey	abdy
abbeys	abdye
abbot	ab
abbots	abte
abbreviate	afkort
abbreviation	afkorting
abdicate	abdikeer
abdication	abdikasie
abduct	ontvoer
aberration, error, mistake	fout
abesses	abdisse
abessinia	abessinië
abessinian	abessinies. abessiniese
abessinian	abessiniër
abet, aid, assist, help, accomodate	help
abet, support, sustain	ondersteun
abetter, abettor, accessory, accomplice	handlanger
abide, bear, carry out, endure, put up with	staan, uithou
abide, expect, wait, await, wait for	verwag
abide, expect, wait, await, wait for	wag, wag vir
abiding, lasting, constant, continual, permanent	vas
abiding, lasting, constantly, continually	permanent
ability, guess, presume, suppose, surmise	vermoë
ability, qualification	kwalifikasie
abjure, abnegate	afsweer
abjure, abolish, abrogate, annul, cancel, remit	kanselleer
ablative	ablatief
able	geskoolde
ablution	ablusie
abnormal	abnormaal, abnormale
abnormality	abnormaliteit
abode, accommodation, dwelling, residence	woning
abolish	afskaf
abolition	afskaffing
abolition, abrogation	opsegging
aboriginal, domestic	binnelands
aboriginal, domestic, native	inheems
aboriginal, originally	oorspronklik
abort	aborteer
abortion	aborsie, abortus
abortionist	aborteur
abortive	abortief, abortiewe
abortive, useless, futile, vain	vrugteloos
about, approximately	omtrent, sowat
about, approximately, like this, so, that way	so
above	hierbo
above all, especially, chiefly, mainly	hoofsaaklik, veral
above ground	bogronds
above, above-mentioned	bogenoemd
above, over, on top, overhead, upstairs	bo
above-board, honest	eerlik
abridgement, abridgment, abstract, resumé	oorsig
abrogate	abrogeer
abrupt	abrup, abrupte
abscess	abses
abscond	weghardloop
absence	absensie, absentia
absence	afwesigheid
absent onself, depart, go away, leave, departure	vertrek
absent, absentee (a)	afwesig, afwesige
absentee (n)	die afwesige
absentees	afwesiges
absinthe	absint
absolutelly	absoluut
absolutely, actually, in fact, genuinly, indeed	sowaar
absolutely, definitely, without fail	beslis, definitief
absolutely, genuinly, indeed, really, truly	regtig
absolution	absolusie
absolution, pardon	vergifnis
absolutism	absolutisme
absolve	absolveer
absorbe	absorbeer
absorbent	absorbeermiddel
absorption	absorpsie
abstract (a)	abstrak
abstract (v)	abstraheer
abstraction	abstraksie
abstruse, mysterious	misterieus
absurd	absurd, absurde
absurd	sinneloos
absurdity	absurditeit
abundant	oorgenoeg
abundant (vegetation)	geil
abuse of office	ampsmisbruik, ampsmisdryf, ampsoortreding
Abyssinian	Abessiniër
acacia	akasia
academic (a)	akademies
academic (n)	academikus
academic (n)	akademikus
academic exercise(s)	akademies(e) oefening(e)
academic year	akademiejaar
academic, scholar, student	student
academics	academici
academics	akademikusse
academy	akademie
acatiosis	akariose
accelarator pedal	versneller(pedaal)
accelerate	akselereer
acceleration	akselerasie
accent	aksent
accent, accentuate, stress	beklemtoon
accentuate	aksentueer
accept	aanvaar
accept	aksepteer
accept, receive, take, take in	aanneem, aanvaar
accept, receive, take, take in, get, lay hold of	neem
acceptability	aanvaarbaarheid
acceptable	aanvaarbaar, aanvaarbare, aanneembare
acceptance	aanvaarding
acceptance of office	ampsaanvaarding
access (n.)	toegang (s.nw.)
accessible	toeganklik
accessory, secondary	sekondêr
accident	ongeluk
accidental	abuise
acclamation	akklamasie
acclimatisation	akklimatisasie
acclimatise	akklimatiseer, akklimatisering
accolade	akkolade
accommodate	akkommodeer, akkomodeer
accommodation	akkommodasie
accommodation, agreement, appointment, date	afspraak
accomodate, end, finish, terminate	eindig
accomplish, attain, reach	bereik
accomplish, attain, reach	presteer
accord (n)	akkoord
accord (v)	akkordeer
accordeon	akkordeon, pensklavier
according to plan	planmatig, planmatige
according to, along	volgens
account, record, report, scholary report	rapport
accountant	rekenmeester
accredit	akkrediteer
accreditatio	akkreditasie
acculturate	akkultureer
acculturation	akkulturasie
accumulate	akkumuleer
accumulation	akkumulasie
accumulator	akkumulator
accumulator, battery, storage battery	battery
accuracy	akkuraatheid
accurate	akkuraat, akkurate
accurate, precise, correct, exact, proper, right	juis
accusation	aantyging
accusations	aantyginge, aantygings
accusative	akkusatief, akkusatiewe
accuse	aankla, aanklaag
accustom, be in the habit of	gewoond wees
acetaldehyde	asetaldehied
acetic acid	asynsuur
ache, be painful, hurt	seer wees
achievement of outcomes	bereiking van uitkomstes
achievement(s)	prestasie(s)
achilles' heel	achilleshiel
achilles' tendon	hakskeensening
acid	suur
acid ratio	suurverhouding
acidic soil	suurgrond
acidity	asiditeit, suurheid
acne	aknee
acoustics	akoestiek
acquaintance, knowledge	kennis
acquire, attain, get, obtain	verwerf
acquire, attain, get, obtain, accomplish, reach	behaal
acquisition	aanwins
acrobat	akrobaat
acrobatic	akrobaties, akrobatiese
acrobats	akrobate
acronym	akroniem
acrophobia	akrofobie
acropolis	akropolis
act	optree
act as	ageer
act, action	daad
act, do, make, perform	doen, maak, pleeg
acting as	agerend, agerende
action	aksie
action committee	aksiekomitee
action, activity	aksie
actionable	aksionabel
actions	aksies
activate	aktiveer
activating	aktiverend, aktiverende
activation	aktivering
activator	aktiveerder, aktiveermiddel
active	aktief, aktiewe
activity	aktiwiteit
actor	akteur
actors	akteurs
actress	aktrise
actresses	aktrises
actual, real	effektief
actual, relevant	aktueel, aktuele
actuality	aktualiteit
actuarial	aktuarieel, aktuariële
actuaries	aktuarisse
actuary	actuarius
actuary	aktuaris, aktuarius
acupuncture	akupunksie, akupunktuur
acute	akute, akuut
acute	akuut (bv é)
ad, advertisement	advertensie
adam's apple	adamsappel,  komhalertjie
adapt	adapteer
adaptable	aanpasbaar, aanpasbare
adaptation	aanpassing
adaptation	adaptasie
adaptations	aanpassinge, aanpassings
adaptive	adaptief, adaptiewe
add	byvoeg,  toevoeg
addition	addisie
additional	addisioneel, addisionele
additional, another	nog 'n
additional, supplementary	aanvullend, aanvullende
address	adres
address	adresseer,  toespreek
address (n)	adres
address (v)	adresseer
address book	adresboek, adresboekie
addressee	geadresseerde
adequate	adekwaat
adhesion	adhesie
adhesive tape, sellotape	plakband
adjacent	aanliggend, aanliggende
adjacent, nearby, neighbouring	naburig
adjust, put right	verstel
adjutant	adjudant
administer the sacrament	inseën van nagmaal, die nagmaal bedien
administrate	administreer
administration	administrasie
administration costs	administrasiekoste
administration, management	administrasie
administration, management	beheer
administration, management	kontrole
administrative	administratief
administrative law	administratiefreg
administrative offices	administrasiekantoor
administrator	administrateur (m), administratrise (f)
admiralty	admiraliteit
admiration	admirasie
admire	bewonder
admission	admissie
admit, confess, profess	bieg
ado, din, noise	ophef
ado, din, noise, riot, tumult	lawaai
adolescence	adolessensie
adolescent	adolessent
Adonis	Adonis
adopted child, adoptee	aannemeling
adoption	aanneme, aanneming
adoption	adopsie
adoptive	adoptief, adoptiewe
adoration	adorasie
adore	adoreer
adornment, decoration, ornament	sieraad
adrenalin	adrenalien, adrenaline
adriatic	adriatiese
Adriatic, Adriatic Sea	Adriatiese See
adulation	adulasie
adult, full-grown	volwasse
adulterate	adultereer
adultery	egbreuk
advance and retard capsule	vervroeg- en vertraagkapsule
advance in the priesthood	vorder in the priesterskap
advance, approach, come close, come closer	naderkom
advancement	vordering
advantage	aanwins
advantage, benefit	voordeel
advantageous, favourable	gunsteling-
adventist	adventis
adventurer	avonturier
adventurous	avontuurlik
adverb	bywoord
adverbial	bywoordelik
adversary	teenstander
advertise	adverteer
advertise, announce, give notice	adverteer
advertise, announce, give notice, report	meld
advertisement, advert, ad	advertensie
advertiser	adverteerder
advertising agency	advertensieburo
advertising campaign	advertensieveldtog
advice	advies
advice, counsel	raad
advise	adviseer
advise, counsel	aanraai
advisor	adviseur
advisory	adviserend, adviserende
advisory body	adviesliggaam
advisory capacity	adviesfunksie
advisory committee	advieskomitee
advocate, barrister	advokaat
advocate, lawyer	advokaat
Aegean Sea	Egeïese See
aerate	ontgas
aerial (automotive)	antenne
aerial (automotive)	lugdraad
affable, friendly, good-natured, kind	vriendelik
affair	affêre
affair, business, business deal, case, matter	ding
affair, business, business deal, case, matter	saak
affect (v)	affekteer
affect, call at, cause, give rise to	aandoen
affect, influence	beïnvloed
affectation	affektasie
affection, emotion	aandoening
affection, emotion	emosie
affidavit	affidavit
affiliate	affilieer
affiliation	affiliasie
affinity	affiniteit
affirmative	affirmatief, affirmatiewe
affix, join, glue	aanheg
affront (n)	affront
affront (v)	affronteer
Afghan	Afghaan
Afghanistan	Afghanistan
afraid	bang
afraid	beangs
Africa	Afrika
african horned toad	platanna
african languages	afrikatale
african policy	afrikabeleid
african unity	afrika-eenheid
African, Afrikaans, Afrikaans language	Afrikaans
africanisation	afrikanisering
africanise	afrikaniseer
africanist	afrikanis
afrikaans-speaking	afrikaanssprekend, afrikaanssprekende, afrikaanstalig, afrikaanstalige
afrikander bull	afrikanerbul
afrikander cattle	afrikanerbeeste
afrikander cow	afrikanerbees, afrikanerkoei
afrikander ox	afrikaneros
afrikaner boy	afrikanerseun
afrikaner woman	afrikanervrou
Afrikaner, Afrikander	Afrikaner
Afrikaner, Afrikander, Boer	Boer
afrikaners	afrikaners
Afro-Asian	Afro-Asiaties
after	agterna
after	nadat
aftertaste	nasmaak
afterwards, next, subsequently	daarna
again, all over again, anew, once more, weather	weer
agar	agar
agararian	agraries, agrariese
age	ouderdom
age of accountability	ouderdom van toerekenbaarheid
aged	verouderd
ageing	veroudering
ageing potential	verouderingspotensiaal
agencies	agentskappe
agency	agentskap
agents	agente
aggregate	aggregaat
aggregated (adj.)	saamgestel(de) (b.nw.)
aggressive	aggressief, aggressiewe
aggressor	aggressor
aging	veroudering
agitation	agitasie
agitator	agitator
agnostic	(a)	agnosties, agnostiese
agnostic (n)	agnostikus
agnosticism	agnostisisme
agnostics	agnostici, agnostikusse
ago	gelede
agoraphobia	agorafobie
agreeable, enjoyable, lovely, nice, pleasant	aangenaam
agreeable, enjoyable, lovely, nice, pleasant	heerlik
agreeable, enjoyable, lovely, nice, pleasant	lekker
agreed, OK, O.K., okay	top
agression	aggressie, aggressiwiteit
agricultural product	plaasproduk
agricultural school	landbouskool
agriculture	akkerbou
ahead, foreward	voort
ahead, foreward	vorentoe
ahead, formerly, previously	voorheen
ahead, formerly, previously	vroeër
ahoy	ahooi
aid, assistant, helper, assistent	assistent
aid, help	hulp
aim(s)	doelstelling(s)
aim, goal, purpose	doel
aim, goal, purpose	oogmerk
aim, intend, mean	bedoel
air	lug
air conditioner	lugversorger
air letter, aerogramme	lugposbrief
air-line	lugleiding
air-mail	lugpos
airdried	luggedroog
airfield	vliegveld
airfield, airport	lughawe
Aix-la-Chapelle	Aken
alabaster	albaster
alarm (n)	alarm
alarm (v)	alarmeer
alarm clock	wekker
alarm shot	alarmskoot
alarming	alarmerend
alarmist	alarmisties, alarmistiese
Albanian	Albaans
Albanian	Albanees
albanian (a)	albaans, albaanse, albanees
albanian (n) albanees, albaniër
Albanian, Albanian language	Albanies
Albanian, Albanian language	Albaniese taal
albanians	albanese, albaniërs
albatross	albatros
albinism	albinisme
albino	albino
albinos	albino's
albums	albums
alchemical	alchemisties, alchemistiese
alchemist	alchemis
alchemists	alchemiste
alchemy	alchemie
alcohol content	alkoholinhoud
alcohol poisoning	alkoholvergiftiging
alcohol strength	alkoholsterkte
alcohol trade	alkoholhandel
alcohol-forming power	alkoholvormingsvermoë
alcohol-free	alkoholvry, alkoholvrye
alcoholic (a)	alkoholies, alkoholiese
alcoholic (n)	alkoholis
alcoholics	alkoholiste
alcoholism	alkoholisme
alcove	alkoof
alcoves	alkowe
aldehyde	aldehied
alder	els
alder	elsboom
ale, beer	bier
alert (a)	waaksaam, op die hoede
alert (n)	waarskuwing
alert (v)	waarsku
alert, brisk, keen	lewendig
Aleutian Islands	Aleoete
Alexandria	Alexandrië
alexandrian	aleksandryn
algebra	algebra
algebraic	algebraïes, algebraïese
Algeria	Algerië
Algerian	Algeryn
Algerian	Algeryns
algerian (a)	algeryns, algerynse
algerian (n)	algeryn
Algiers	Algiers
algorythm	algoritme
alias	alias
alias	alias, pennaam
aliases	alliasse
alien, foreign, strange	vreemd
alienated	ontheemde
alienation	aliënasie
aliens, refugees	ontheemdes
alimentary	alimentêr, alimentêre
alimentation	alimentasie
aliteration	alterasie
alkaline (a)	alkalies, alkaliese
all	al die
all	alle
all about, everywhere	oral
All Hallows, All Saints' Day	Allerheilige
all kinds of	allerlei
all night	heelnag
all of a sudden, suddenly	skielik
all souls day	allersieledag
All Souls' Day	Allersiele
all the same, equally, a while, momentarily	ewe
all the time, in the meantime, meanwhile	intusse
all the time, in the meantime, meanwhile	solank
all the time, in the meantime, meanwhile	tegelyk
all the way	heelpad
all, each, every, everyone	almal
all, each, every, everyone	elke
all, each, every, everyone	elkeen
all-covering	allesbedekkend, allesbedekkende
all-encompassing	allesomvattend, allesomvattende
all-encompassing	alomvattend, alomvattende
all-father	alvader
all-knowing, omniscient	alwetend, alwetende
all-overpowering	allesoorheersend, allesoorheersende
all-saints day	allerheiligedag, allerheiligefees
all-seeing	alsiende
allegorical	allegories, allegoriese
allegories	allegorieë
allegory	allegorie
allergen	allergiewekker
allergic	allergies, allergiese
allergies	allergieë
allergy	allergie
alliance	alliansie
alliances	alliansies
alligator	alligator
alliterate	allitereer
alliteration	alliterasie
allocate	allokeer, toeken
allopathic	allopaties, allopatiese
allopathy	allopatie
allow, leave, let, release, late, tardy	laat
alloy	allooi
alloys	allooie
allright, OK	skaflik, skaflike
alltogether, in toto, in total	altesaam, altesame
alluvial	alluviaal, alluviale
alluvial	alluviale
alluvial soil	alluviale grond
ally (v)	allieer
alm	aalmoes
almanac	almanak
almanacs	almanakke
Almighty	die Almagtige
almond	amandel
almost	amper, ampertjies
almost, nearly	amper
almost, nearly	byna
alms	aalmoes
aloe	aalwee, aalwyn
alone	alleen
alone, only, sole, solitary	alleen
alone, only, sole, solitary	enigste
alpaca	alpakka, alpakkabok
alphabetical	alfabeties, alfabetiese
alpine	alpyns, alpynse
alpine horn	alpehoring
alpinist, mountaineer	alpinis
already	alras, alreeds
already, by now, yet	al
already, by now, yet	alreeds
already, by now, yet	reeds
already, by now, yet, finished, through	klaar
already, yet, all	al
Alsace	Elsas
Alsace, Elsass	die Elsas
Alsace, Elsass	Elsas
Alsatian	Elsasies
Alsatian	Elsasser
also, too	ook
Alt key (alternate)	Alt sleutel
altar piece	altaarstuk
altars	altare
alter, change, turn	verander
altercation	alterkasie
alternate	alterneer
alternating	alternerend, alternerende
alternative	alternatief, alternatiewe
alternative, option, choice, election	keuse
alternatively	alternatiewelik
alternator	alternator
alternator indicator/ guage	alternatormeter
although	alhoewel
altogether, everything, all of it	alles
altruism	altruïsme
altruist	altruïs
altruistic	altruïsties, altruïstiese
altruists	altruïste
aluminium alloy	aluminiumlegering
aluminium ore	aluminiumerts
aluminium oxide	aluminiumokside, aluminiumoksied
aluminium, aluminum	aluminium
aluminium, aluminum (US)	aluminium
alumni association	alumnusvereniging
always	altoos
always	steeds
always, never-ending	alewig, alewigdeur
amalekite	amalekiet
amalgam	amalgaam
amalgamate	amalgameer, amalgamering
amalgamation	amalgamasie
amateur	amateur
amateur athlete	amateuratleet
amateur boxer	amateurbokser
amateur drama	amateurtoneel
amateur dramatic society	amateurgeselskap
amateur painter	amateurskilder
amateur, fancier, dabbler, dilettante	amateur
amateurish	amateuragtig, amateuragtige
amateurism	amateurisme
amateurs	amateurs
amaze	verbaas
amazon river	amasonerivier
amazons	amasones
ambassador	ambassadeur (m), ambassadrise (f)
amber	amber
amber coloured	amberkleurig
amber-coloured	amberkleurig, amberkleurige
ambergris	ambergrys
ambition	ambisie
ambitions	ambisies
ambitious	ambisieus, ambisieuse
ambivalence	ambivalensie
ambivalent	ambivalent, ambivalente
ambulance	ambulans
ambulance service	ambulansdiens
amend	amendeer
amendment	amendement, amendering
amenorrhea	amenorree
america	amerika
America, United States of America, USA	Amerika
American	Amerikaans
American	Amerikaner
american (a)	amerikaans, amerikaanse
american (n)	amerikaner
American, US citizen	Amerikaner
americanisation	amerikanisasie
americanise, coka-colonise	amerikaniseer
americans	amerikaners
amethyst	ametis
amicable	amikaal, amikale
amino acid	aminosuur
amino acids	aminosure
ammunition	ammunisie
amnesia	amnesie
amnesties	amnesties, amnestieë
amnesty	amnestie
amoeba	amebe
amoebic dysentery	amebedisenterie
among, between	tussen
amontilado	amontillado
amontilado	mediumdroog sjerrie
amoral	amoreel, amorele
amorality	amoralisme, amoraliteit
amorous	amoreus, amoreuse, amoureus, amoureuse
amorphous	amorf, amorfe
amortisation	amortisasie
amortise	amortiseer
amortize, deaden, write off	afskryf
amount	bedrag
amount, number	aantal
amount, sum	bedrag
ampelography	ampelografie
ampere, ampère	ampère
ampersand	ampersand, en-teken (&)
amphibian (a)	amfibies, amfibiese
amphibian (n)	amfibie
amphibians	amfibieë
amphitheatre	amfiteater
amphora	amfora
amphoras	amforas, amfore
amplification	amplifikasie
amplitude	amplitude
amplitude-modulated	amplitudegemoduleerde
ampule	ampul
amputate	amputeer
amputation	amputasie
amusement	amusement
amusing	amusant, amusante
anabaptism	anabaptisme
anabaptist (a)	anabaptisties, anabaptistiese
anabaptist (n)	anabaptis
anabaptists	anabaptiste
anachronism	anachronisme
anaconda	anakonda
anaerobic	anaërobies
anaesthetic	anestesie
anagrams	anagramme
anal	anaal
anal	anale
analyse	analiseer
analyse	ontleed
analyses	analises
analyst	analis
analyst	ontleder
anarchism	anargisme
anarchist	anargis
anarchy	anargie
anathema	anatema
anathemise	anatematiseer
anatomy	anatomie
anchor chain	ankerketting, ankertou
anchor pole	kopendpaal, ankerpaal
anchor wire	ankerdraad
anchovy	ansjovis
and	en
andes mountain range	andesgebergte
androgenous	androgeen, androgien
androgyny	androginie
anecdote	anekdote
anemia	anemie
angel	engel
Anglican	anglikaan (s.nw) , anglikaans, anglikaanse (b.nw)
Anglican Church	Anglikaanse Kerk
Anglo-Saxon	Angel-Sakser
Anglo-Saxon	Angel-Saksies
anglo-saxon (a)	angel-saksies, angel-saksiese
Angola	Angola
animal, beast	dier
animation	animasie
aniseed	anys
annotation, note	kommentaar
announce	aankondig
announce, proclaim	afkondig
announcement	aankondiging
announcement, proclamation	afkondiging
announcements	aankondiginge, aankondigings
announcer (f)	aankondigster
announcer (m)	aankondiger
announcers	aankondigers
annual, yearly	jaarliks
anoint (v)	salf (ww)
anointing	salwing
anonymous	anonieme
answer	antwoord
answer	beantwoord
answer, reply, respond	antwoord
answerable	beantwoordbaar
antagonise	antagoniseer
antarctic	antarkties
Antarctic	Suidpool-
Antarctic Ocean	Suidelike Yssee
Antarctic, the Antarctic	Antarktika
antenna	antenne
antharcnose	swartroes
anthocyanin	antosianien
anthracnose	antraknose
anthrax	antraks
anthropoid	antropoïde
anthropology	antropologie
antichrist	antichris
Antilles	Antille
antilock brake	sluit(be)standrem
antilope	anteloop
antipathy	antipatie
antiquary	antikwaar
antique	antiek
antiques dealer	antiekhandelaar
antisemitic	anti-semities
anxious	bekommerd
any time, momentarily	enige tyd
anything, something	enigiets
anything, something	iets
anywhere, somewhere	êrens
apart, particular, separate, special	afsonderlik
apartment, flat	woonstel
ape-like	aapagtig, aapagtige
ape-man	aapmens
aphid	plantluis
aphorism	aforisme
aphrodisiac	afrodisiakum
Apocalypse	Openbaring
apocrypha	apokriewe
apostle	apostel
apostles	apostels
apparatus	apparaat
apparatus, device, set	toestel
appeal (n)	appél
appeal (v)	appelleer
appeal to, invoke	oproep
appear, appear to be, seem	skyn
appear, emerge, perform	verskyn
appear, look, cadaver, corpse, appear to be, seem	lyk
Appelation controlée	appelation controlée
appellation, name	naam
appendix	aanhangsel
appendix, codicil, rider	bylae
appetiser	aptytwekker
appetiser	aptytwekker, aptytwekkertjie
appetising	aptytlik
appetite	aptyt
applause	applous
apple blossoms	appelbloeisels
apple juice	appelsap
apple orchard	appelboord
apple pie	appelpastei
applicant	applikant
application	toepassing, applikasie (minder algemeen gebruik)
apply, practice	toepas
appointed place	afspraakplek
appointed time	afspraaktyd
appointment	afspraak
appointment book	afspraakboek
appointment, appointment to office	aanstelling
appreciate, like	hou van
appreciate, like	lief wees vir
appreciate, like	waardeer
appropriate, becoming, seemly, suitable	geskikt
appropriateness	toepaslikheid, gepastheid
apricot jam	appelkooskonfyt
April	April
april fool	aprilgek
april fool's joke	aprilgrap
APS selector	APS kieser
aptitude	aanleg
aptitude test	aanlegtoets
Apulia	Apulië
apératif wines	aperitiefwyne
apéritif	aptytwekker
aquamarine	akwamaryn
aquarelle	akwarel
aquatic	akwaties, akwatiese
aqueduct	akwaduk
Arab	Arabier
arabesque	arabesk
arabian	arabier(s.nw), arabies, arabiese (b.nw)
Arabian, Arabic	Arabies
Arabs	Arabiere
arbitrate	arbitreer
arbitration	arbitrasie
arcady, arcadia	arkadië
arch-enemy	aartsvyand
arch-priest	aartspriester
archaeology	argeologie
archaic	argaïes
archangel	aartsengel
archbishop	aartsbiskop
archbishopric	aartsbisdom
archdeacon	aartsdeken
archduchess	aartshertogin
archduke	aartshertog
archdukes	aartshertoë
arched cane	boogloot
archetype	argetipe
Archie	Archie (argiefstelsel)
archipelago	argipel
architect	argitek
architecture	argitektuur
archive	argief
archive (n)	argief
archive (v)	argiveer, boekstaaf, wegbêre
archives	argief
arctic	arkties, arktiese
Arctic	noordpool-
Arctic Ocean	Yssee
Arctic, the Arctic	Noordpool
Ardennes	Ardenne
area	area
area	oppervlakte
area, region	gebied
arena	arena
Areopagus	Areopagus
Argentina	Argentinië
Argentine	Argentyn
Argentine, Argentinean	Argentyns
Argentinian	Argentyn
argumentation	argumentasie
Argus	Argus
arial grafting	lugenting
arian (a)	aries
arian (n)	ariër
aridity	ariditeit
aristocracy	aristokrasie
aristocrat	aristokraat
arj	arj (kompressieformate)
arm	arm
arm rest	armleuning
arm rest	armrus
arm, miserable, poor	arm
armadillo	armadil
armchair	armstoel
Armenian	Armenies
Armenian	Armeniër
armpit	armholte
army	leër
aroma, flavour	geur
around the back	agterlangs
arrange, fix up, regulation, rule	reël
arrest (n)	aanhouding
arrest (n)	arrestasie
arrest (n)	hegtenis
arrest (v)	arresteer
arrival	aankoms
arrival	koms
arrival (abstract)	aankoms
arrival (person, ie a new arrival)	aankomeling
arrive, get	aankom
arrive, get	arriveer
arrive, get	beland
arrogant	pretensieus
arrow	pyl
arsenal	arsenaal
arsenic	arseen
art	kuns
art gallery	kunsgalery
artery	aar
arthropod	skaaldier
artichoke	artisjok
article, commodity	artikel
articles of faith	geloofsartikels, artikels van geloof
articulation	beweeglikheid
articulation	gewrig
articulation	skarnier
artificial	onnatuurlik
artificial fruit	nagemaakte vrugte
artificial, artistic, clever, dexterous, skillful	kunstig
artillery	artillerie
artillery fire	artillerievuur
artist	kunstenaar
artistic	artistiek, artisties
arum lily	aronskelk
Aryan	Aries
Aryan	Ariër
as ... as, so ... as	so ... soos
as if	as't ware
as if	asof
as if, as though, in a way	asof
as to, as regards, concerning, with reference to	ten opsigte van
as well as	asook
as, how, like, such as	so lyk
as, how, like, such as	soos
asbestos	asbes
ascend, climb, go up	opgaan
ascend, get up, go up, lift, rise, arise	styg
Ascension Day	Hemelvaartdag
ascetic (a)	asketies, asketiese
ascetic (n)	askeet
asceticism	askese, asketisisme, asketisme
ASCII (American Standard Code for Information Interchange)	ASCII
ascorbic acid	askorbiensuur
ash	as
ash heap	ashoop
Ash Wednesday	Asdag
ash, cinder, when, how, like, such as, than, if	as
ash-coloured	askleurig, askleurige
ashtray	asbak
Asia Minor	Klein-Asië
Asian	Asiaat
asian (a)	asiaties, asiatiese
asian (n)	asiaat, asiër
Asian, Asiatic	Asiaties
ask, ask for, beg, bid, request	vra
asocial	asosiaal
aspect	aspek
asphalt	asfalt
asphalt road, tar road	asfaltpad
aspire, aspire to, hope for, run for election	aansoek doen
aspirin	aspirien, aspirine
ass, donkey	donkie
ass, donkey	esel
ass, donkey	groutjie
assailant	aanrander
assault	aanslag
assault (v)	aanrand, aanranding
assault, attack	aanval
assegai, spear	assegaai
assent, say yes, confirm, corroborate	bevestig
assessable	assesseerbaar
assessment	assessering
assessment criteria	assesseringskriteria
assessment strategy	assesseringstrategie
asset	bate
assign	daag
assistant director	assistentdirekteur
assistant manager	assistentbestuurder
association, society	vereniging
assume	aanneem
assumption	aanname
assumption(s)	aanname(s)
assumptions	aannames
assure, certify, make certain	seker maak
assure, certify, make certain	sertifiseer
Assyria	Assirië
Assyrian	Assiries
Assyrian	Assiriër
asterisk	asterisk, sterretjie (*)
asteroids	asteroïde
asthma	asma
asthmatic	asmaties
astringency	vrankheid
astringent, tart	vrank
astronaut	heelalvaarder
aswered	beantwoord
asylum	asiel
asylum, place of refuge, shelter	toevlugsoord
at	by (@), aapstert (minder formeel) (cmdp)
at a strech, for ... together, on end	namekaar
at all, entirely, wholly	heeltemal
at home	tuis
at last, finally, ultimately	uiteindelik
at least	ten minste
at night, by night	snags
at once, instantly, immediately, without delay	dadelik
at present, now	nou
at present, now	tans
at some time, ever	eendag
at some time, ever, first, firstly, first of all	eers
at the back	agteraan
at the right time, in time	betyds
at the right time, in time	op tyd
at, beside, by, near to, next to, alongside	langs
at, beside, by, near to, next to, close, nearby	naby
at, beside, by, near to, next to, with	by
at, by, on, across from, against, in exchange for	jeens
at, by, on, across from, against, in exchange for	teen
at, by, on, beside, with	om
atheist	ateïs
Athena, Athene, Athens	Athene
athletic	atleties, atletiese
athletics	atletiek
Atlantic	Atlanties
Atlantic, Atlantic Ocean	Atlantiese Oseaan
Atlas	Atlas
atlas mountains	atlasgebergte
atmosphere	atmosfeer
atoll	atol
atomic bomb	atoombom
atomic energy	atoomenergie
atoms	atome
atonement	versoening, soendood
attach	attasjeer
attach, determine, fasten, fix, affix, make fast	vasmaak
attach, determine, fasten, fix, affix, make fast	vasstel
attache case	aktetas
attachment	aanhangsel (e-pos)
attack	aanval
attack force	aanvalsmag
attacker, foe, enemy	aanvaller
attacking	aanvallend, aanvallende
attempt to seduce, bring into harbour	aanlê
attempt, effort, test	poging
attempt, test, try	aanpak
attempt, test, try	probeer
attend, be present, witness	bywoon
attend, call on, see, visit	kuier
attend, nurse, tend to	verpleeg
attention	attensie
attentive	aandagtig, aandagtige
Attic	Atties
attract, decoy, lure	lok
attraction	aantrekkingskrag
attraction	attraksie
attractive features	aantreklikhede
attractiveness	aantreklikheid
auctioneer	afslaer
audible frequency	gehoorfrekwensie
audience	gehoor
audiences	gehore
audit, check, check up on, supervise, verify	kontroleer
Augean stable	Augiasstal
Augeas	Augias
August	Augustus
august	augustus, augustusmaand
augustinian	augustyner
aunt	tant
aunt	tante, tannie, antie
Australian	Australies
Australian	Australiër
australian (a)	australies, australiese
australian (n)	australiër
Austria	Oostenryk
Austrian	Oostenryker
Austrian	Oostenryks
authentic	outentiek(e)
authentication	geldigheidsvasstelling
author, writer	skrywer
authorisation	magtiging
authority	gesag
authority, glamor, glamour, prestige	gesag
auto-detect	selfspeur, outospeur
auto-reliable	outobetroubaar
auto-reverse system	automatiese terugrolstelsel
autoload	outolaai
automatic detection	outomatiese bespeuring, outospeur
autonomous, independant	onafhanklik
autumn	herfs
auxilary tan	khulptenk
auxiliry tank	reservoir
available	beskikbaar
average, middle	medium
average, middle, mean	gemiddeld
avid, eager for, greedy	gretig
avocado pear	advokadopeer
avoid, evade	vermy
away, distant, far, remote, far away, remotely	ver
axial	aksiaal
axiom	aksioma, aksioom
axiomatic	aksiomaties
axle length	asafstand
axles	asse
azores	asore
Azores	Asoriese Eilande
Aztec	Astekies
Baal	Baäl
babble	babbel
baboon	adoons
baboon	bobbejaan
Babylonia	Babilonië
Babylonian	Babilonies
babysitter	babawagter
back	rug
back	terug
back button	terugknoppie
back door	agterdeur
back of the head	agterhoof, agterkop
back pocket	agterbbroeksak
back-to-front	agterstevoor
backbencher	agterbanker
backfire (automotive)	terugslag
background	agtergrond
background information	agtergrondinligting, agtergrondsinligting
background information	agtergrondsinligting
background reading	agtergrondleeswerk
background, bottom, foundation	agtergrond
backside	agterkant
backside	agterstewe
backside, rump, behind, bottom, buttocks	agterent
backslash	terug-skuinsstrepie, agtentoeskuinsstrepie, (kyk ook wick)
backstreet	agterstraat
backward moderated	ná gemodereer, terug gemodereer
backward, mentally deficient, retarded	agterlik
bad, miserable, nasty, poor	kwaai
bad, miserable, nasty, poor, badly	sleg
badger	ratel
badit	bandiet
bag, sack	tas
baggage, luggage	bagasie
bait (n)	aanlokmiddel
bait (n), carrion	aas
bake	bak
bake, fry, tub, vat, basin, bowl, pelvis, jug	bak
baked	gebak
bakery	bakkerswinkel, bakkery
baking powder	bakpoeier
balance	balans
balance control	balanskontrole (radio)
balcony	balkon
bale	baal
baleen whale	baleinwalvis
Balkans	Balkan
ball	bal
ballet	ballet
ballgame	balspel
ballistic	ballisties, ballistiese
ballistics	ballistiek
balloon	ballon
balloonist	ballonreisiger
ballroom	balsaal
balsa wood	balsahout
Baltic	Balties
Baltic Sea	Oossee
bamboo	bamboes
bamboo leaves	bamboesblare
banana bread	piesangbrood
banana farmer	piesangboer
banana peel	piesangskil
bananas	piesangs
bandage, relation, understanding	verband
bank	bank
bank balance	bankbalans
bank guarantee	bankgaransie
bank manager	bankbestuurder
bank note, banknote, bank-note	noot
bank robber	bankrower
bank, border, edge, shore	oewer
bankers	bankiers
bankmeester
bankrupt	bankrot
bankrupt, insolvent	bankrot
bankruptcy, insolvency	bankrotskap
banner, flag	vlag
banners	baniere
banquet	banket
bantamweight	bantamgewig
Bantu	Bantoe
Bantu	Bantoe-
bantu language	bantoetaal
bantustans	bantoestans
baptise, baptize	doop, die doop bedien
baptism	doop
baptism by immersion	doop deur onderdompeling
baptism for the dead	doop vir die dode
baptismal prayer	doopsgebed
baptist church	baptistekerk
baqueting hall	banketsaal
bar, pub	drinkpan
barbarian	barbaar
barbaric	barbaars, barbaarse
barbarities	barbaarshede
barbecue braai
barber's shop	barbierswinkel
barber, hairdresser	haarkapper
barefoot	barrevoets
barely, hardly, only just, scarcely, rare	skaars
bark, husk, peel, shell	skil
baroque	barok
barrel	vat
barrel, channel, pipe, tube	buis
barricade (n)	barrikade
barricade (v)	barrikadeer
barrier(s)	versperring(s)
base (n)	basis
base coating	grondlaag
Basel, Basle	Basel
baseline	basislyn
basement, cellar	kelder
basic	basies
basic	basies, basiese
basic priesthood functions	basiese priesterskapfunksies
basket	mandjie
Basque	Bask
Basque	Baskies
bass	baars
bass notes	basnote
bass singer	bassinger
bastard	baster
bat-eared fox	bakoorjakkals
batallion	bataljon
Batavian	Bataaf
Batavian	Bataviaan
Batavian	Batavier
bath towel	badhanddoek
bather	baaier
bathing suit, bathing-suit	swempak
bathrobe	badjapon, badjas
baton, cane, stick	stok
battery	battery
battery acid	batterysuur
battery box	battery kis(sie)
battle, scuffle, struggle	geveg
battle-cry	aanvalskreet
baud	baud
Bavaria	Beiere
Bavarian	Beier
bayonet	bajonet
bazaar, fair, market, marketplace	mark
BBS (Bulletin Board Service)	BBS (bulletinborddiens)
be	wees
be able to, can, may	kan
be absent, be missing	ontbreek
be acquainted with, know	ken
be alive	leef
be ashamed	skaam hom
be asleep	slaap
be bankrupt, go broke	bankrot raak
be called, be named	heet
be considered, count	in aanmerking kom
be fond of, love	mal wees oor
be glad, enjoy, rejoice, delight in	geniet
be hungry	honger wees
be lacking, be missing	foresti
be late	agter wees
be sorry about, regret	jammer wees
be succesful, prosper	floreer
be thirsty	dors wees
be willing to, want, wish, willingness	wil
beach	strand
bead	kraal
bead	pêreltjie
bead	wynbelletjie
beads	skuim
beak, bill	snawel
beam, ray, radio, wireless	radio
bear	beer
bear, produce	oplewer
bear, produce	produseer
beard	baard
bearded	bebaard, bebaarde
bearer (person)	draer, portier
bearer (vines)	draerloot
bearer (vines)	drasnit
bearing	laer
bearless	baardloos
beast of prey	roofdier
beat a retreat	die aftog blaas
beat up	afransel
beating	afranseling
beatings	afranselings
beautiful woman, beauty	skone
beautiful, fine, handsome, lovely	deftig
beautiful, fine, handsome, lovely	mooi
because of, on account of, for sake of	weens
because, for the reason that	deurdat
because, for the reason that, since	aangesien
because, for the reason that, since	omdat
because, for, since	want
become, come about, grow, happen, get	raak
become, come about, grow, happen, get	word
bed	bed
bed linen, bedding	beddegoed
bed-ridden	bedlêend, bedlêende
bed-wetting	bednatmakery
bedmate	bedgenoot
Bedouin, Beduin	swerwer
Bedouin, Beduin	woestynbewoner
bedroom	slaapkamer
beds	beddens
bedsheet	bedlaken
bedstead	bababed
beech	beuk
beef	beesvleis
befit, be fitting	betaam
before	alvorens
before	voordat
before anything else, first of all	allereers, allereerste
before, in front of	voor
beg	bedel
beggar	bedelaar
beggary	bedelary
begin, commence, start	instel
begin, commence, start, beginning, commencement	begin
beginner	beginner
beginningless	aanvangloos
behave, conduct oneself	gedra hom
behaviour, conduct, deportment, position	houding
behead	onthoof
beheading	onthoofding
behind	agter
behind, after, aback, backwards	agter
Belgian	Belg
Belgian	Belgies
Belgium	België
Belgrade	Belgrado
believe, deem	glo
believe, deem, guess, presume, suppose, surmise	meen
bell pepper	soetrissie
bellflower, Canterbury bell	klokkie
bellflower, Canterbury bell	koppies-en-pierings
bellflower, Canterbury bell	mariëteklokke
bellhousing	klokhuisie
bellhousing	klokhulsel
bellies	pense
belly	pens
belong to	behoor aan
below, beneath, under, underneath	onder
below, downstairs, underneath	onderaan
belted radial tyre	strookstraallaagband
bench	bankie
bench graft	tafelenting
bench, school	skool
bend	buig
bend over backwards	agteroorbuig
benefit (v)	baat
benefit, gain, profit	profyt
Bengal	Bengale
Bengal	Bengalees
bentonite	bentoniet
beret	baret
Berlin	Berlyn
Berlin	Berlyns
Berliner	Berlyner
Bern, Berne	Bern
berry	bessie
berry (grape)	druiwekorrel
beseech	smeek
best	beste
best of all	allerbes, allerbeste
beta	beta, b-uitgawe
Bethlehem	Betlehem
betrayal, treachery	verraad
better	beter
beyond, past, straight past	verby
bias	sydigheid (radio)
bid down	afbie
big	groot
big (taste)	vol
big, great, large	groot
bike, cycle, bicycle	fiets
bikini	bikini
bill, invoice, calculation, account	rekening
bill, ticket, note	kaartjie
billiards	biljart
bin	wynrak
binary (adj)	binêre
binary (n)	binêre lêer, grafika (meer spesifiek)
bind, connect, join, tie, tie up	bind
binding, strip, tape, tyre	band
biomass	biomassa
birch	berk
birch	berkeboom
bird	voël
birth	geboorte
birthday	verjaarsdag
bishopric	bisdom
bison	Amerikaanse buffel
bison	bison
bit	bis
bite	byt
bite off	afbyt
bitterness	galsterigheid
black	swart
black (person)	swartmens, swarte
black currant (cassis)	swartbessie
black grapes	swart druiwe
black olive	swart olyf
black pepper	swart peper
black rots	wartvrot
Black Sea, Euxine Sea	Swart See
black-mould rot, aspergillus rot	swartmufvrot, aspergillus rot
blackberry	swartbessie
blackmail (n)	afdreiging
blackmail (n)	afpersing
blackmail (v), threaten	afdreig
blackmail(v)	afpers
blackmailer	afperser
Blanc de blanc	Blanc de blanc
Blanc de noir	Blanc de noir
Blanc fumé	Blanc fumé
blank	oop
blank, white	blank
blank, white	wit
blanket	deken
blazer	baadjie
bleak, chilly, cold	koud
bleak, dark, dismal, dreary, dim	donker
bleak, dismal, dreary, horrible, ghastly, grisly	onaangenaam
bleed (person, animal)	bloei
bleed (plant)	huil
bleep	bliep(geluid) (radio)
bleeps	joeigeluid (radio)
blend (n)	versnit (wyn), mengsel
blend (v)	versny, meng
blend, mingle, mix, shuffle	meng
blended	versny, gemeng
blended wine	versnitwyn
bless	seën
bless a child	'n kind seën
bless the bread	die brood inseën
bless the sacrament	die nagmaal inseën
bless the sick	die siekes seën
bless the water	die water inseën
blessings	eën, seëning
blind	blind
blind carbon copy (bcc)	blinde koolkopie, geheimkopie (bcc), (bkk)
block, pad	blok
Bloemfontein	Bloemfontein
blood	bloed
blood red, blood-red	bloedrooi
bloom, flower	blom
blouse	bloese
blow	blaas
blow	waai
blow off	afblaas
blow off	afwaai
blow, butcher, slaughter	slag
blue	blou
blue casse	bloubreuk
Bluebeard	Bloubaard
blushing	blosend
boardroom	raadskamer
boast, brag	spog
bobbin, coil, spool, gargle, rinse	spoel
body	liggaam
body (automotive)	bakwerk
body production plant	bakproduksieaanleg
body, fullness (wine)	volheid, lyf
Bohemia	Boheme
Bohemian	Boheems
boil, cook	kook
bold print	donkerdruk, swartdruk
Bolivia	Boliwië
Bolivian	Boliwies
bologna, baloney, polony	polonie
Bolshevik	Bolsjewiek
Bolshevik	Bolsjewis
bolt	knip
Bombay	Bombaai
bonnet (automotive)	enjinkap
bonus	bonus
book	boek
Book of Mormon	Boek van Mormon
book of remembrance	gedenkboek
book, order, reserve	bestel
book-keeping	boekhou
booking-office	kaartjieskantoor
bookmark	boekmerk
bookmark link	boekmerkskakel (in 'n HTML-dokument)
booster	versterker (remme)
boot	stewel
boot (automotive)	bagasiebak
boot (automotive)	kattebak
border fence	grensdraad
bore	boor
bore and stroke	boor en slag
boring, tiresome	vervelig
borrow	leen
bosom, breast, chest	bors
boss	baas
boss, chief, leader, master	baas
botanical	plantkundig
botanist	plantkundige
botanists	plantkundiges
botany	plantkunde
bother	pla
botrytis, noble rot	botritis, edelvrot
bottle	bottel
bottle cork	bottelkurk
bottle fermentation	bottelgisting
bottle-fermented wine	bottelgegiste wyn
bottled	gebotteleer
bottled vintage port	oesjaarport
bottleneck	bottelnek
bottom yeast	bodemgis
bottoms	moer
bough, branch	tak
bounce (e-mail)	terugbons (e-pos aflewering), terugbons (netwerksein), bons (netwerk)
boundary, frontier, limit	grens
bouquet	boeket
boutique, shop, store	winkel
bovine, bovine animal	bees
bow legs	bakbene
bowl	kom
box	doos
box	kas, boks (rekenaar)
box, jug, container, vessel	boks
boxer	bokser
boy	seun
Brabant	Brabant
Brabantine	Brabander
Brabantine	Brabants
bracelet	armband
brackets	hakies
brain	brein
brake	rem
brake line	remlyn
brake lining	remsool
brake lining	remvoering
brake pad	remkussing
brake pedal	rempedaal
brake shoe	remskoen
brakes	remme
branch	tak
branch correlation committee	takskakelkomitee
branch, compartment, department, pigeonhole	afdeling
branch, compartment, department, pigeonhole	vak
brandish, fling, swing, wave, wave about	swaai
brass	geelkoper
Braunschweig, Brunswick	Brunswyk
Brazil	Brasilië
Brazilian	Brasiliaan
Brazilian	Brasiliaans
bread	brood
bread, loaf	brood
break	breek
break down	afbreek
break, intermission, pause, recess	pouse
breakable, brittle, fragile	breekbaar
breakfast	ontbyt
breath	adem, ademhaling
breath control	asembeheersing
breath-taking	asembenemend, asembenemende, asemberowend, asemberowende, asemrowend, asemrowende
breathe	asem
breathe	asemhaal
breathing (n)	asemhaling
breathing apparatus	asemhalingstoestel
breathing exercise	asemhaaloefening
breathless	ademloos, ademlose
breathless	asemloos
breechloader	agterlaaier
breed	aanteel
breed, bring up, educate, raise, teach	oplei
breed, keep, raise, rear	aanhou
breed, keep, raise, rear	teel
breed, race	ras
Bretagne, Brittany	Bretagne
bribe (n)	afkoopgeld
bribe (v)	afkoop
brick	baksteen
brick house	baksteenhuis
bricks	bakstene
bride, fiancée	verloofde
bridge	brug
bright blue	potblou
bright, brilliant	blink
bright, brilliant	skitterend
bright, clear, light, distinct, plain	helder
bring along, take along	meebring
bring along, take along	saambring
bring, fetch	bring
Britain, Great Britain	Groot-Brittanje
British	Brits
Briton	Brit
broken heart and contrite spirit	'n gebroke hart en verslae gees
broken, out of order, damaged	stukkend
broker	eiendomsagentskap
bronze	brons
bronze plates	koperplate, bronsplate
brood mare	aanteelmerrie
brothel	bordeel
brothel	hoerhuis
brother	broer
brow, eyebrow	wenkbrou
brown	bruin
browse	deurblaai
browser	deurblaaier
Bruges	Brugge
brush	borsel
brush	penseel
brush stroke	penseelstreek
Brussels	Brussel
Brussels	Brussels
Brussels-sprouts	Brusselse spruitjies
bubble (n)	borrelruitjie
bubblesborrels, vogblasies
Bucharest	Boekarest
bucket seat	komsitplek
buckle	gespe
buckle	knip
bud	botsel
bud	knop
bud	oog
budburst	bot
Buddha	Boeddha
Buddhist	Boeddhis
Buddhist	Boeddhist
buddy, companion, comrade, pal	makker
budmite	knapmyt
buffalo	buffel
buffer	buffer
buffer, bumper	buffer
buffoon, jester, clown	nar
builder	bouer
building	gebou
built-in	ingeboude
Bulgar, Bulgarian	Bulgaar
Bulgaria	Bulgarye
Bulgarian	Bulgaars
bulk, dimension, extend, size	grootte
bull	bul
bullet	koeël
bullet points	koeëltjies, dotlys
bulletin board (non-computer)	aanplakbord
bumper (automotive)	buffer
bumper (automotive)	stamper
bunch	tros
bunch, bundle, cluster, sheaf	bondel
bung	prop (van groot vat), spons
burden, load	belaai
burdensome, heavy, onerous	swaar
bureacracy	penlekkery, pennelekkery
bureacrat, official, pointy-headed manager	penlekker, pennelekker
bureau, office	buro
burglar	inbreker
Burma	Birma
Burmese	Birmaan
Burmese	Birmees
burn	aanbrand
burn down	afbrand
burn, conflagration, fire	brand
burn, incinerate	verbrand
burned	gebrand
burnt match	gebrande vuurhoutjie
bus stop, busstop	bushalte
bus, autobus, omnibus	bus
bush vine	bosstok
bush, shrub	struik
bush-trained vine	bosstok
bushbuck	bosbok
Bushman	Boesman
business management	sakebestuur, besigheidsbestuur
business, commerce, trade	handel
busy	beset
busy	besig
but, however, nevertheless, yet	egter
but, however, nevertheless, yet	maar
but, however, nevertheless, yet	nietemin
butcher	slagter
butterfly	skoenlapper
butterfly valve	vleuelklep
buttermilk	karringmelk
butterscotch	karringmelk
button	knoppie
butyric acid	bottersuur
buy, purchase	aankoop
buy, purchase	aanskaf
buy, purchase	koop
buyer	aankoper
by day, during the day, in the daytime	bedags
by, by means of, through, with, door, gate	deur
bye, goodbye, so long	tot siens
byte	greep
Byzantine	Bisantyns
Byzantium	Bisantium
cabaret	kabaret
Cabernet	Cabernet
Cabernet Sauvignon	Cabernet Sauvignon
cabinet, closet, cupboard, sideboard	kas
cache	kas, kasgeheue
cadre, frame, framework	raamwerk
Caesar	Caesar
cafetaria	kafeteria
cage	hok
Cain	Kain
Cairo	Kaïro
calipe	rmeetpasser
caliper	knyper
call	roep, roeping
call preference	oproepvoorkeur
caller, visitor	besoeker
calling	roeping
calm, quiet, tranquil	kalm
calsium chloride	kalsiumchloried
Calvary, Golgotha	Kalvarieberg
Calvary, Golgotha	Kruisberg
Calvin	Calvyn
camel	kameel
camera	kamera
Cameroon, Cameroun	Kameroen
camp, be encamped, lie encamped, camp out	kampeer
campaign	veldtog
camping ground, camping site	kampeerterrein
camping ground, camping site, camp of tents	kamp
camshaft	nokas
can, tin, tin can	blik
Canada	Kanada
Canadian	Kanadees
canal, channel	kanaal
Canary	Kanaries
canary	pietjie-kanarie
Canary Islands	Kanariese Eilande
cancel	afstel
cancer, canker	kanker
candidate	applikant
candidate	kandidaat
candle	kers
Candlemas	Maria-ligmis
Candlemas	Vrouedag
cane	hoofloot
cane	lat
cane (drink)	rietsnaps
cane, walking stick	wandelstok
canned	(in)geblik
cannon	afweergeskut, afweerkanon
canopy	afslaankap
canopy strand	loofdraad
Canticles, Song of Solomon, Song of Songs	Hooglied
capacity	slagvolume
Cape	Kaaps
Cape Province	die Kaapprovinsie
Cape Province	Kaapprovinsie
Cape Town	Kaapstad
Capitol	Kapitool
Capricorn	Steenbok
caps	pette
captain	kaptein
capture (v)	gryp
capture, catch, grapple	vang
capture, catch, grapple, get, lay hold of	vat
car park, lay-by, parking bay, parking garage	parkeerplek
car, automobile	motor, motorkar, kar
car, automobile, motor car, motor-car	motor
car, cart, chariot	kar
carafe	kraffie
caramelized	gekarameliseerd
carbon copy (cc)	koolkopie (cc), (kk) (minder algemeen gebruik)
carbon copy, facsimile, copy (of a paper)	afskrif
carbon dioxide	koolstofdioksied
carbon dioxide	koolsuurgas
carbonation	karbonering
carburettor	vergasser
care about, take care of	bekommer hom
care for, cure, treat	behandel
care, see, take care, worry	sorg
careful, cautious	versigtig
careful, tender	sorgvuldig
careless	agteloos, agtelose, agtelosig, agtelosige
careless	argeloos
carelessness	agteloosheid, agtelosigheid
caret	karet, kappie (^)
carion-eater	aasdier, aasvreter
Carmelite	Karmeliet
carnal	vleeslike
Carpathians	Karpate
carpet	mat
carriage return	reëleinde, reëlend
carrier	draer
carrier	draermiddel
carrier position	draerposisie
carrion-eating	aasvretend, aasvretende
carrot, root	wortel
carry	abba
carry, wear	dra
Carthage	Carthago
Carthaginian	Carthager
cash, in cash	kontant
casino	casino
cask	vat
cask ramp	vatlaaibrug
casmouflaged	gekamoefleer, gekamoefleerde
Caspian Sea	Kaspiese See
casserole, saucepan, cooking pot, frying-pan	pan
cassette	kasset
cassette slot	kassetgleuf (radio)
cast (n)	afbeeldsel
cast a shadow	oorskadu
Castillian	Kastiliaans
castle	kasteel
castle, tower	toring
castrate	ontman
catalog, catalogue, directory	katalogus
Catalonia	Katalonië
Catalonian	Katalaans
catch, hit, run across, strike	tref
catfish	baber
Catholic	katoliek
Catholisism	katolisisme
Caucasus	Kaukasus
cause, give rise to	veroorsaak
cause, reason, logical reasoning	rede
caution, warn	waarsku
cave, grotto, cavern, den	grot
cedar	seder
cede, give in, give up, give way, relinquish	afstaan
ceiling	plafon
ceiling beams	plafonbalke
ceilings	plafonne, plafons
Celebes	Celebes
celebration	selebrasie
celebration	viering
celebration, festival, party, many, a lot of	party
celestial glory	selestiale heerlikheid
celestial kingdom	selestiale koninkryk
celestial marriage	selestiale huwelik
celestial plan	selestiale plan
celestial world	selestiale wêreld
cell connector	selaansluiting
cell connector	selverbinding
cellar	kelder
Celt	Kelt
cent	sent
centaur	perdmens
centennial, century	eeu
centerstand	middelstaander
centimeter, centimetre	sentimeter
central	sentraal
centre click position	middelstop-posisie (radio)
centre console	middel konsole
centre electrode	kernelektrode
centre electrode	middelelektrode
centre stand	middelstaander
centrifugal pump	sentrifugale pomp
centrifuging	sentrifugering
certainly	sekerlik
certainly, probably	seker
certificate, testimony	sertifikaat
Ceylon	Ceylon
chain of office	ampsketting
chain saw	bandsaag
chair	stoel
chairman, president	voorsitter
challenge	uitdaging
chamber, room	kamer
Champagne	Champagne
champagne	sjampanje
chance, event, occurence, opportunity	geleentheid
chance, luck	kans
change	kleingeld
change bands	bandverandering (radio)
change in personality	persoonlikheidsverandering
change of address	adresverandering
channel (n)	kanaal
chaos, tangle	chaos
chapel	kapel
chapter	hoofstuk
char	meid
character	karakter
character set	karakterstel
character, nature, personality	karakter
characteristic	kenmerkend
characteristic, typical	tipies
Chardonnay	Chardonnay
charge	aanklag
charge office	aanklagkantoor
charges	aanklagte
charity	armesorg
charity	liefde (teenoor die medemens), liefdadigheid
charity, love of one's neighbour	naasteliefde
charm (n)	sjarme
charm (v)	sjarmeer
charm school	sjarmeskool
charmat method	charmat-metode
charming	allerbekoorliks, allerbekoorlikste
charming	sjarmant, sjarmante
charred	verkool
chase, hunt after, hunt for, pursue	ten doel hê
chassis	onderstel
chaste	kuis
chastity	kuisheid
chat	klets, gesels
chateau bottled	chateau-gebotteleer
cheap, inexpensive	goedkoop
cheat, crook, rogue, scoundrel	ploert
check (n)	regmerkie
check (v)	nagaan
check, cheque	tjek
checkmate	skaakmat
cheek	wang
cheerful, gay, merry	vrolik
chemical	chemies
chemical denotation	chemiese denotasie
chemist's shop, drugstore	apteek
chemistry	chemie
chemistry	chemie 
Chenin blanc	Chenin Blanc, Steendruif
cheque-book	tjekboek
cherry	kersie
cherubim	gerubs
chessboard	skaakbord
chew	kou
Chianti wine	Chianti-wyn
chicken, fowl	hen
chicken, hen, fowl	hoender
child, offspring, young, infant	kind
Chilean	Chileen
Chilean	Chileens
chime	klinkel
China	China
chocolate cake	sjokoladekoek
choke	smoor
choke (automotive)	smoorklep
choke (automotive)	versmoorder
choose, elect, pick out	kies
choose, elect, pick out	verkies
Christian	Christen
Christian name	doopnaam
Christian name	voornaam
Christmas tree, Christmas-tree	kersboom
Christmas, Christmas feast	Kersmis
Christmas, Christmas feast, Yule	Kersfees
church court	kerklike hof
Church of Jesus Christ of latter-day saints	die Kerk van Jesus Christus van die heiliges van die laaste dae
church, kirk	kerk
cider	appeldrank, appelsider
cigar	sigaar
cigarette	sigaret
Cinderella	Asepoestertjie
cinderella	aspoester, aspoestertjie
cinema, movie theatre	bioskoop
cinema, movie theatre	fliekhuis
cipher, digit, figure, numeral	syfer
circle	sirkel
circular (a)	sirkelvormig, sirkelvormige
circular (a)	sirkulêre
circular movements	sirkelbewegings
circular saw	sirkelsaag
circulate	sirkuleer
circulation	sirkulasie
circulatory system	aarstelsel
circumstance	omstandigheid
circumstances, condition, situation, state	situasie
circumstances, condition, situation, state	toestand
circus	sirkus
cirrhosis	sirrose
citadels	sitadelle
citation	sitaat, sitasie
cite, quote	aanhaal
citrus	sitrus
citrus farm	sitrusboedery
city of Zion	die stad Sion
city, town	stad
civilization	beskawing
claim (n)	aanspraak
claimant	aanspraakmaker
claims	aansprake
clamp, bracket, parenthesis, staple	hakie
clan, clique, coterie, junto, set	kliek
clap, click, rattle	klik
claret	klaret
clarity	helderheid
clash	(statements)	bots (stellings)
class	klas
class, course	kursus
classic, classical	klassiek
classical music	klassieke musiek
clean, cleanse, make clean, purge	skoonmaak
clean, pure	skoon
clean, pure	suiwer
cleaning	skoonmaak
cleanly cut, net, neat, precize	netjies
clear	helder
clear	opklaar
clear coating	helder deklaag
clearly	duidelik
clerk	kantoorklerk
clever, cunning, sly, smart	slim
client	kliënt
client, customer	kliënt
client-server relationship	kliënt-bedienerverhouding
climate	klimaat
climb	kim
climb	klim
climb down	afklim, afklouter
climbing plants	rankplante
clinic	kliniek
clip, cut, shear, slice	sny
clock	horlosie
clock	klok
clone	kloon
close off	afdig
close, intimate, cardiac, cordial, hearty	innig
close, near, nearby, next	aanstaande
close, shut	toemaak
closing speech	afsluitingstoespraak
clothe, dress	klee
clothes, clothing	klere
cloudiness	troebelheid
clouding	vertroebel
clouding	vertroebeling
cloudy	troebel
cloves	(krui)naeltjie(s)
cloyed	stroperig
cloying	stroperig
club, society	klub
clustering	saamgroepering
clutch	koppelaar
clutch (automotive)	koppellaar
clutch pedal	koppelaar(pedaal)
clutch, grab, grasp, grip, seize	gryp
coach (n)	afrigter
coach (n) (sport)	afrigster (f), afrigter (m)
coach (v)	afrig (ww.)
coach (v) (sport)	afrig
coaches (sport)	afrigters
coal	steenkool
coastal region	kusstreek
coat, overcoat	jas
cobra	kobra
cock, rooster	haan
cocktail	kelkie
cocktail	skemerkelkie
cod, codfish	kabeljou
code	kode
cognac	cognac, konjak
cognitive	kognitief
coherence	eenvormigheid
coin	geldstuk
coin	munt
coin	muntstuk
coin	penning
cold fermentation		koue gisting
collaborative	samewerkend(e)
colleague	ampgenoot, ampsgenoot
colleague	kollega
colleagues	ampgenote
collect e-mail	gaan haal/kry e-pos
collect, gather, pick up	versamel
collect, gather, pick up, join, unite	bymekaarbring
collection	bundel
collection	insameling
collection	versameling
college	kollege
collide	bots
collision	botsing
Cologne	Keulen
colon	dubbelpunt (:)
colony, settlement	kolonie
colour painting	kleurdeklaag
colour, dye, tint	kleur
coloured (n), half-blood	gekleurde
Columbus	Columbus
column, header	rubriek
column, pillar	kolom
com port (communications port)	com-poort (kommunikasiepoort), kom-poort
comb	kam
combination	kombinasie
combine, connect, join	verbind
combustion chamber	ontbrandingskamer
come	kom
come about, happen, occur	gebeur
come about, happen, occur	geskie
come about, happen, occur	plaatsvind
come across, encounter, meet, see	ontmoet
come across, encounter, meet, see	sien
come back, return	terugkom
come down	afkom
comedy	komedie
comfort, console, consolation	troos
comfortable	gemaklik
comfortable	gerieflik
comforter	trooster
command line (adj)	reëlopdrag=, reël-vir-reël-
command line (n)	opdragveld, opdraglyn
commander	kommandant
commander, leader	aanvoerder
commandment	gebod
commandments	gebooie
commend, glorify, laud, praise, price	prys
commission	kommissie
commission, errand	opdrag
commissioned of jesus christ	in opdrag van jesus christus (optree)
commitment	toegewydheid
common, ordinary, usual	gewoon
commonplace, dismal, trite, daily	alledaags
commotion, scandal	aanstoot
commotion, scandal	skandaal
communicate, report, let know, inform	meedeel
commute (transport)	pendel
commuter	pendelaar
commuters	pendelaars
compact	kompak
company, firm	firma
compare	vergelyk
comparison	vergelyking
compartment, coupé	koepee
compartment, coupé	kompartement
compassionate	barmhartig, barmhartige
compatible	versoenbaar
compel, force	dwing
compel, force	verplig
compensate, reward	beloon
compensation	skadevergoeding
compensation, reward	vergelding
competence	bevoegdheid
competition, contest	kompetisie
competition, contest, game, match	wedstryd
complain	kla
complete	aanvul
complete, full, completely, fully	vol
completely	algeheel, algehele
completely	heeltemal
composition	samestelling
comprehensive	omvattend(e)
compression	kompressie
compression ratio	drukverhouding
compressor	kompressor
compressor	perspomp
compressor turbine	kompressorturbine
compressor turbine	perspompturbune
comprise, contain, include	bevat
computer	rekenaar
computer	rekenaar, komper (arg.)
concept	konsep
concern (v)	aanbetref
concern, relate, traffic, be found, be located	verkeer
concerned, in question	betrokke
concert	konsert
conclusion, effect, result	uitslag
conclusion, inference	gevolgtrekking
condemnation	verdoeming, verdoemnis
condensate (v)	kondenseer
condense	kondenseer
conduct, direct, guide, head, lead	lei
confectioner	banketbakker
conference	konferensie
confidence, faith, trust	vertroue
configuration utility	konfigurasieprogram, opstelprogram, opsteller
configure	konfigureer, opstel
confirm	beaam
confirm	bevestig
confirm, corroborate	erken
confirmation (religion)	aanneme, aanneming
Confucius	Confucius
congenital	aangebore
Congo, Zaire	Kongo
conjunction	voegwoord
connect	verbind (algemeen), konnekteer (sok), koppel (kommunikasie, bv internet)
connection	konneksie
connection	verbinding
consecrate	wy (aan)
consecrated oil	gewyde olie
consecutive	agtereenvolgend, agtereenvolgende
consequently, so, subsequently	gevolglik
conserve, keep, maintain, preserve	bewaar
consider, deem, look, look at, regard, view	kyk
consider, deem, look, look at, regard, view	kyk na
consider, esteem, regard, think, think about	oorweeg
considerable	aansienlik, aansienlike
considerably	aansienlik
consommé	consommé
constant (n.)	konstante (s.nw.)
consternation	konsternasie
constitution	grondwet
consul	konsul
consult	raadpleeg
consumer	verbruiker
contact	kontak
contact period	kontakperiode
contemporary	hedendaags, hedendaagse
contented, pleased, satisfied	tevrede
contents	inhoud
continent, mainland	vasteland
continually	aan-aan
continually	aaneen
continually	aanhoudend
continue	aanhou
continuous	aanhoudende
continuous, interlinked	aaneengeskakel, aaneengeskakeld, aaneengeskakelde
continuously	aanmekaar
contour	sloop
contract	kontrak
contralto	alt
contrast	teenstelling
contrite spirit	verslae gees
control	beheer
control, govern, restrain, rule	regeer
controls	kontroles (radio)
conversation	gesprek
conversation, interview	onderhoud
convert	bekeer
convertable (automotive)	afslaandakmotor
convertable (automotive)	cabriolet
convertable (automotive)	kabriolet
converted (to be converted)	om jou te bekeer, bekeer te word
conveyer	vervoerder
cooked	gekook
cooked cabbage	gekookte kool
cookie	kolwyntjie, koekie, beskuitjie
cool	koel
cool	koud
cool down	afkoel
cooling fan	koelwaaier
cooling fan	verkoelwaaier
cooling installation	afkoelingsinstallasie
cooling surface	afkoelingsoppervlak
cooling system	koelstelsel
cooling system	verkoelstelsel
cooperate, co-operate	saamwerk
cop, police officer	polisiebeampte, polisiedienaar, polisieman
Copenhagen	Kopenhagen
copper pot-stills	koperpotketels
copy	kopiëer
copyright	kopiereg
cord line	plantlyn
cordon	kordon
cordon wire	kordondraad
cordon wire trellising	kordondraagstelsel
core, nucleus, kernel, pit	pit
Corinthian	Korinthies
cork	kurk
cork (n)	prop
cork (v)kurk (v)
corked taste	kurksmaak
corking machine	propmasjien
corky taste	vatsmaak, kurksmaak
corn, Indian corn, maize, mealies	mielies
cornered, caught up with	aangekeer
corrode	aantas
corrosion	korrosie
corrupt	korrup (clc)
cost, food, nourishment	kos
costly, valuable	waardevol
costume, outfit, suit	pak klere
cottage	kothuis
cottage system	gewelstelsel
cough	hoes
council in heaven	raad in die hemel
council of the twelve apostles	raad van die twaalf apostels
councillor	raadslid
counselor	raadgewer
count	tel
country code	landkode
coupè	koepee
courage	dapperheid
courage	durf
courage	moed
court	hof
cousin (f)	niggie
cousin (m)	neef
cousin, nephew	neef
covenant	verbond
cover	bedek
cover	dek
cover (v)	afdek
cover crop	dekgewas
covered	bedekte
covered in blood	bebloed
covet	begeer
cow	koei
coward	bangbroek, bangerd, banggat
cower, crouch, squat	hurk
cower, shrink	ineenkrimp
cracker (comp)	krapper (kyk ook hacker)
cracking	barstend, barstende
crankcase	krukkas
crawl, creep	kruip
crayfish, lobster	kreef
crazy, insane, mad, nuts	mal
cream	room
cream	vla
cream liqueur	roomlikeur
create	kreëer
creator	skepper
credit	krediet
credit card	kredietkaart
Crete	Kreta
Crimea	die Krim
Crimea	Krim
crisis, depression, emergency	krisis
crisp	krokant, vars, verfrissend
criterion (...ria)	kriterium (...ria)
criticize	kritiseer
Croat	Kroaat
Croatia	Kroasië
Croatian	Kroaties
crockery set	eetservies
crocodile	krokodil
cross	kruis
cross, go beyond, transfer	oorskry
cross, go beyond, transfer	oorsteek
cross-disciplinary	kruisdissiplinêr(e)
cross-ply tyre	kruislaagband
cross-ply tyre	oorkruislaagband
cross-post (v)	kruispos
crowd	skare
crowd, heap, mass, multitude, pile	menigte
crowd, heap, mass, multitude, pile, band, bevy	skare
crowd, heap, mass, multitude, pile, lump	massa
crowd, heap, mass, multitude, pile, stack	stapel
crown cork	kroonkurk
crucifixion	kruisiging
crucify	kruisig
crude oil	aardolie
crude, raw, rough	rou
cruel	wreedaardig
crusher	parsmasjien
crust	kors
crutch	kruk
cry of alarm	alarmkreet
cry out, scream, shout	skreeu
crystal	kristal
Ctrl key (control)	Ctrl sleutel (control)
Cuba	Kuba
Cuban	Kubaan
Cuban	Kubaans
cubby hole	mossienes
cubby hole	paneelkassie
cubby hole	paneelkissie
cube	kubus
cultivar	kultivar
cultivate, grow	aankweek
cultivate, grow	kweek
cultivator	skoffelploeg
cultivator, nurser	kweker
culture	kultuur
cup	koppie
Cupid, Eros	Cupido
Cupid, Eros	Kupido
Curaçao	Curaçao
curfew	aandklok
curl, froth, stir, whip, whirl, move	roer
curly brackets	krulhakies ({})
curly quotes	krulaanhalingstekens
current, present, present-day	huidig
curry	kerrie
curse	vloek, vervloeking
curse (n)	banvloek
curtain	gordyn
cushion	kussing
custody	sorg
custom	doelveranderde, doelgemaakte
custom, habit, way	gewoonte
custom, habit, way, employ, use, make use of	gebruik
customise	doelmaak
cut	sny
cut off	afknip
cut off, chop off	afkap
cut, cut a connection	afskakel
cut-out button	afsluitknoppie
cutlery	tafelgereedskap, tafelgerei, tafelservies, tafelsilwer
cutworm	miswurm
cycle	fietsry
cylinder	silinder
cynical	sinies
Cypriot, Cypriote	Cipries
Cypriot, Cypriote	Ciprioot
Cyprus	Ciprus
Czech, Czechoslovak, Czechoslovakian	Tsjeg
Czech, Czechoslovak, Czechoslovakian	Tsjeggies
Czechoslovakia	Tsjeggo-Slowakye
daemon	daemoon
daffodil	affodil
daily	daagliks
dainty, delicate, fine, refined	delikaat
dainty, delicate, fine, refined	teer
dairy farm	melkboerdery
dairy farmer	melkboer
Dalmatia	Dalmasië
damage, injure, spoil, bribe	bederf
dame, king, queen	dam
dance	dans
Dane	Deen
Danish	Deens
Danube	Donau
Dardanelles	Dardanelles
dare to take on	aandurf
dare, be bold	waag
dark, dim	duister
darling, treasure	skat
darn	verbrands
data bit	databis
date	dateer
date	datum
daughter	dogter
daughter, girl, lass	dogter
day	day
Day of Atonement, Feast of Expiation	Versoendag
day of rest	rusdag
dazed, perplexed, upset	deurmekaar
dazed, perplexed, upset	verbysterd
dazed, perplexed, upset	verward
deacon	diaken
dead, death	dood
deaf	doof
deal, distribute	uitdeel
dear	geag
dear john letter	afsêbrief
dear, expensive, lovely, valuable, costly, pricey	duur
debatable	aanvegbaar, aanvegbare
debit order	aftrekorder
debit order facility	aftrekorderfasiliteit, aftrekordergeriewe
debug (n)	ontvlooiingsprogram
debug (v)	ontvlooi, ontgogging (cmdp)
decade	dekade
decant	dekanteer, oorskink, oorgiet
decanter	kraffie
December	Desember
decent, fitting, proper, suitable, decently	behoorlik
decide	besluit
deciduous	bladwisselend
declaration, proclamation, statement	verklaring
declare, state, explain	verklaar
decode	dekodeer
decor, décor, decoration	dekor
decorking	ontkurking
decrepit	aftands
decrepit wine	afgeleefde wyn
dedicate	toewy
dedicate, devote, pay out, spend	spandeer
dedicated	toegewyd
deduct	aftrek
deductible	aftrekbaar, aftrekbare
deduction	aftrekking
deed (of a house)	akte
deeds office	aktekantoor
deem, opine, think	dink
deep, profound	diep
deer	hert
default gateway	grond deurgangspoort
default value	verstekwaarde (clc), grondwaarde
defeat, win over	verslaan
defend	verdedig
defenestrate	ontmaagd
deficit	agterstand
define, determine, attach, fasten, fix, affix	bepaal
definitely not	aikôna
definition	definisie
degorgement	degorgement
degreasing	ghriesverwydering
degree of colour	graad van rosigheid
degree of sweetness	soetheidsgraad
degree, grade, heading, title	graad
dehydrate	ontwater
Del (delete)	Del (delete)
delay, retardation	vertraging
delegate, send a representative	afvaardig
delegation	afvaardiging
delete	uitvee, uitwis, wis
deletion	wissing, uitwis, uitwissing
delicacy, tidbit, sweet	lekkers
delicious	heerlik, heerlike
delightful, lovely	verruklik
delineate	afbaan, afbaken
delineated, set apart	afgebaken
deliver	aflewer
deliver (v)	aflaai
deliver, furnish, supply	aflewer
deliver, furnish, supply, convey, hand, hand over	inlewer
deliveries	afleweringe, aflewerings
delivery vehicle	afleweringsvoertuig, afleweringswa
deluxe, de luxe, luxurious, luxury	luukse
demand, postulate, require	vereis
demi-sec	demi-sec
democracy	demokrasie
democratic	demokraties
democratic participation	demokratiese deelname
demonstrable	bewysbaar, demonstreerbaar (...bare)
demonstrate	bewys, demonstreer
denial	ontkenning
Denmark	Denemarke
denouement	ontknoping
dentist	tandarts
deny	ontken
department	afdeling
department	departement
department store	afdelingswinkel
department store, warehouse, bazaar	afdelingswinkel
departmental manager, head of department	afdelingsbestuurder, afdelingshoof
departmental secretary	afdelingsekretaris
depend	afhang
dependants	afhanklikes
dependent	afhanklik, afhanklike
depending on	afhangend van, afhangende van
depict	afbeeld
depict, represent	uitbeeld
depicted	afgebeeld
depiction	afbeelding
deport	deporteer
deposit	deponeer
depth	diepte
deputy director	adjunk-direkteur
deputy minister	adjunk-minister
descend	afdaal
descend from	afstam van
descend, get off, go down	afgaan
descend, go down, land	daal
descendant	afstammeling
descendants	afstammelinge
descent	afstamming
descent, lineage	afkoms
description	beskrywing
design (v.)	ontwerp
design, outline, sketch	skets
desirable	aanloklik, aanloklike
desire, wish, long for, yearn	verlang
desk, lectern, school desk	lessenaar
desktop	tafelblad
desludg	ingafsak
despite, in spite of, notwithstanding, defiantly	ten spyte van
dessert	nagereg
dessert wines	dessertwyne, likeurwyne
destination	bestemming
destiny, fate, ill fate, fortune, luck	lot
detail	besonderheid
detail	detail
detect	bespeur
detrimentally, disadvantageously, prejudicially	nadelig
Deuteronomy	Deuteronomium
develop, reveal	ontwikkel
development, evolution	evolusie
development, evolution	ontwikkeling
devil	josie
diaeresis	deelteken (bv ë)
diagnostics	diagnostiese toetse
diagonal trellising	skuinskapstelsel
dial	skakel
dial (v)	skakel
dial out (v)	uitbel, bel
dial tone	luitoon
dial, disc, disk, record	plaat
dial, disc, disk, record, slice	skyf
dial-up (adj)	inbel=, inskakel=
dial-up (v)	inbel, inskakel
dial-up networking	inbelnetwerkwerk
dialing tone	skakeltoon
dialogue box	dialoogblokkie, dialoogkassie, dialoogruitjie
diamond	diamant
dictionary, vocabulary	woordeboek
die	sterf
die off, become extinct	afsterf
diesel	diesel
diet	dieet
differ, be different, difference	verskil
different	verskillend
differential	ewenaar
differently	anders
difficult, hard, inconvenient	moeilik
difficulty, trouble	moeilikheid
dilute	afdun
dimension	afmeting
dimension, measurement	afmeting
dimension, measurement	dimensie
dimensions	afmetinge, afmetings
dimensions	afmetings
diminutive, little, small	klein
dining-room	eetkamer
dinner, midday meal	dinee
dinner, midday meal	middagete
dinner, supper	aandete
dinner, supper	avondmaal
dip switch	domp(lig)skakelaar
diploma	diploma
dipstick	oliemaat
dipstick	oliestokkie (kyk ook oil dip)
direct (v)	lei, voorgaan op 'n vergadering
direct, guide, manage, steer	rig
direct, guide, manage, steer, conduct, lead	bestuur
direct, straight	direk
direction	rigting
directions, instruction	instruksie
directly, straigh ahead	regop
director, manager	direkteur
directory	gids
dirty, filthy, nasty, soiled, unclean	vuil
disable	sper
disappear	verdwyn
disapprove	afkeur
disc	skyf
disc skyf
discharge, dismiss, fire, sack	ontslaan
disciple	dissipel
discipline	dissipline
disconnect	ontkoppel, diskonnekteer
discount (n)	afslag
discount shop	afslagwinkel
discourage	ontmoedig
discover, uncover	ontdek
discovery	ontdekking
discrete	losstaande
disease, illness	kwaal
disease, illness	siekte
disfellowship	sensureer, onder sensuur plaas
disfellowshipment	sensuur
disgorge	ontslik
disgrace	skande
disgraceful	skandelik, skandelike
dish up	inskep
dish up	opskep
dishonest	agterbaks, agterbakse
disillusion	ontnuger
disillusionment	ontgogeling
dismiss, turn away	wegstuur
display (n)	uitbeelding, beeld, afbeelding
display (n)	vertoonskerm (radio)
disposal, inclination, tendency	lus
dispose of, sell, vend	verkoop
distance	afstand
distance education	afstandonderrig, afstandsonderrig
distance, offset	afstand
distances	afstande
distillate	distillaat
distilled wine	distilleerwyn
distilled wine	stookwyn
distilling	verstoking, distillering
distract	aflei
distraction	afleiding
distraction, diversion	ontspanning
distributor	verspreider
distributor (automotive)	verdeler
district	distrik
ditch-digger	skaggrawer
diverge	afwyk
divergent	afwykend, afwykende
divorced	geskei
DNA	DNS
do a bodysearch, scan (v)	aftas
dockworker	hawearbeider
doctor	arts
doctor, physician	dokter
doctrine	leer
doctrine and covenants	leer en verbonde
document (v.)	dokumenteer (ww.)
document, paper	dokument
documentation	dokumentasie, handboek (spesifiek)
dog	hond
doll, puppet	pop
dollar	dollar ($)
domain	domein
domain suffix	domeinsuffiks, domeinstert (minder formeel)
domestic	gesins-
Dominican	Dominikaans
dominion	heerskappy
door for driver and courier	bestuurdersdeur
door handle	deurknip
door lock	deurslot
door mirror	kantspieël
door mirror	syspieël(tjie)
door pillar	deurpilaar
door-to-door salesperson	aanklopverkoper
Dorian, Doric	Dories
dot	kol, dot
dot, period, point, spot	punt
double bass player	bassis
double-click	klik-klik, dubbelkliek, dubbelklik
doubt	twyfel
doughy wine	dikwyn
down	ondertoe
down (v)	na onder rol
down (vi)	skakel af, gaan sit ('n netwerk), breek af ('n lyn)
down (vt)	afsit, afskakel, ontkoppel ('n netwerk)
down draught twin choke	tweekeel-valstroom (vergassertipe)
download	aflaai
downward slope	afhelling
downwards	afwaarts, afwaartse
downy mildew	donsskimmel
dozen	dosyn
draft, rough draft, plan, project, scheme	konsep
drag, draw, haul, pull, tug	trek
drag, tow	sleep
drainage	afvoer
drainage area	afvoergebied
drainage pipe	afvoerbuis, afvoerpyp
Drakensberg Mountains	Drakensberge
drama	drama
drape	drapeer
draw back in fear	agteruitdeins
draw out, drive out, express, utter	ontlok
draw out, drive out, express, utter	uithaal
draw, equality	gelykheid
drawer, burden, load	laai
dress, wear, put on	aantrek
dressing up	aantrekkery
dried fruit	droë vrugte
driedd	roë, gedroogde
drift, be adrift, float, swim, chase, drive	dryf
drink, drink to excess	drink
drink, drink to excess	suip
drinking wine	drinkwyn
drip	drup
drip moulding	drupgeut
drip moulding	druplys
drip off	afdruip
drive (v)	aandryf
drive mechanism	dryfmeganisme (radio)
drive unit	aandrywingseenhede
drive-in restaurant	aanrykafee
driver	drywer
driveshaft	aandryfas
driving turbine	dryfturbine
driving-licence	rybewys
drizzle, drizzling rain	motreën
droop, hang	hang
drop a line (v)	laat 'n lyn val
drop, fall	val
drop, fall, remainder, rest, debris, rubbish	afval
drug, medicine, pharmaceutical	medisyne
drum	drom (geselstrant)
drunk, intoxicated	dronk
dry	dor
dry off	afdroog
dryness	droogte
dual circuit	dubbelbaan (remme)
dual link	dubbelskakel (vering)
dual mode	dubbelmodus
dual seat	dubbelsitplek
duck	eend
durability track	duursaamheidstoetsbaan
duration of office	ampsduur, ampstermyn
during the day	bedags
dusk	aandgloed
dusk, twilight	skemer
dust (v), clean (v)	afvee, afveeg
dusty	stowwerig
Dutch	Hollands
Dutch	Nederlands
Dutch Reformed Church	Nederduits Gereformeerde Kerk
Dutchman	Hollander, kaaskop
Dutchman	Nederlander
Dutchman, Hollander	Hollander
duty, obligation	plig
duty, obligation	verpligting
dwarf, midget, pigmy	dwerg
dwell, live	woon
dynamic IP-address	dinamiese IP-adres
e-mail	e-pos, E-pos (AWS-spelling)
each other	mekaar
each other	melkaar
each other, one another	mekaar
eagle	adelaar
eagles' nest	adelaarsnes
ear, above, more than, over, after, about	oor
earless	afoor
earless cup	afoorkoppie
early	vroeg
early	vroegtydig
earn, gain, win	wen
earn, gain, win, be worthy of, deserve, merit	verdien
earth	aarde
earth wire	aarddraad
earth, land, soil	aarde
earth-bound	aardgebonde
earthling	aardbewoner
earthquake	aardbewing, aardskok, aardskudding
earthy	aardagtig
earthy	aards, aardse
East Germany, GDR	Oos-Duitsland
east, East	ooste
Easter	Paasfees
Easter	Pase
eastern, Oriental	oostelik
easy, facile	maklik
eat up, consume, use up	verorber
eat, feed	eet
echo	eggo
economical	ekonomies
ecstasy	ekstase
ED paint tank	E-N-verftenk
Edam	Edam
edelweiss	edelweiss
Eden	Eden
Edinburgh	Edenburg
edit (v)	redigeer
edition	uitgawe
education	onderwys
education	opleiding
educator(s)	opvoeder(s)
eel	paling
eel worm	aalwurm
eel-like	aalagtig, aalagtige
eel-shaped	aalvormig
effect, impression	effek
effect, impression	impak
effect, impression	indruk
effort	moeite
egg	ei
egg	eier
Egypt	Egipte
Egyptian	Egiptenaar
Egyptian	Egipties
eight	ag
eight	agt
eight hunderd	agthonderd
eight-year-old	agtjarige
eighteen	agtien
eighteen	agttien
eighteenth	agttiende
eighteenth century-	agtiende-eeus, agtiende-eeuse, agttiende-eeus, agttiende-eeuse
eightfold	agtdubbel, agtdubbeld
eighth	agtste
eighth man	agsteman
eighth man	agtsteman
eighty	tagtig
eithtfold	agvoudig, agtvoudig, agvoudige, agtvoudige
eject	uitskop (radio)
elder	ouderling
electric	elektries
electrical system	elektriese stelsel
electricity	elektrisiteit
electrodeposit painting	elektro-neerslagverf
electron	elektron
elegant	elegant
element	element
element, fragment, item, particle	item
elemental, elementary	elementêr
elephant	olifant
elevator, lift	hyser
eleven	elf
elicit (- a response)	ontlok (- 'n reaksie)
ellipses	beletselteken (... (net drie kolletjies))
elm	iep
elm	olm
elsewhere	elders
emanation	afstraling
embassy	ambasade, ambassade
embed	inlê
embedded	ingebedde, verskansde
emblem	embleem
emblem	kenteken
emigrate	emigreer
emoticon	emotikon
employee	werknemer
employer	werkgewer
employment bureau	aannemingsdiens
empty, void	pap
emulation	emulasie
enable	ontsper (clc)
enchanter, magician, sorcerer, warlock, wizard	towenaar
encode	enkodeer
encounter (v)	aantref
encourage	aanspoor
encourage	aanvuur
encouragement	aanmoediging
encouragement	aansporing
encouraging	aanmoedigend, aanmoedigende
end a relationship	afsê
end of the world	einde van die aarde, einde van die wêreld
end, come to an end, end up, expire, cease, stop	ophou
end, ending	einde
endowed	bedeeld, bedeelde
endure to the end	volhard tot die einde toe
enemy	vyand
energy	energie
enforce	afdwing
enforceable	afdwingbaar
engage (v.	)betrek
engine	enjin
engine block	enjinblok
engine performance	werkkrag
engine, machine	masjien
engineer	ingenieur
England	Engeland
English, English language	Engels
Englishman	Engelsman, Rooinek
Englishman, Sassenach	Engelsman
enormous, huge, immense	enorm
enormous, huge, immense	geweldig
enormously, extremely	deeglik
enough, sufficient	genoeg
ensign	adelbors
entangle, implicate, confuse, puzzle	verwar
enter password	tik wagwoord in, verskaf wagwoord
enter, insert, put in, put away, stow	insit
enterprise	onderneming
entertainment, amusement, fun	vermaak
enthusiasm	geesdrif
enthusiastic	geesdriftig
entire, overall, whole	hele
entire, overall, whole	volledig
entitled to a pension	pensioengeregtig
entrance, portal	toegang
entrepreneur	entrepreneur
entrepreneurial ability	entrepreneursvermoë
envious	afgunstig, afgunstige
environment, environs, surroundings	omgewing
envy	afguns
Epiphany, Twelfth-night	Driekoninge
Epiphany, Twelfth-night	Driekoningefees
equilibrium	balans
equipment	akkomodasie
equipment	uitrusting
equitable	billik-gelyke
equity	billike gelykheid
errand, message	boodskap
erroneous, mistaken, wrong, false, untrue	verkeerd
erroneous, mistaken, wrong, incorrect	onjuis
error correction	foutkorrigering (die taak), foutkorreksie (die resultaat) (clc)
escape, flee	ontkom aan
escape, flee	ontsnap
Eskimo	Eskimo
Esperantist	esperantis
Esperanto	Esperanto
essay, thesis	stelling
establish	aanlê
estate	landgoed
estate	nalatenskap
estate car	stasiewa
estate wine	landgoedwyn
estate, farm, property, ranch	boereplaas
estate, farm, property, ranch, locate, place	plaas
esteem, regard, respect	aansien
Estonia	Estland
Estonian	Est
Estonian	Ests
et cetera, et caetera	ensovoorts
etc.	ens.
eternal	ewigdurend
eternal father	ewige vader
eternal life	ewige lewe
eternal marriage	ewigdurende huwelik
eternal progression	ewigdurende vordering
eternal, for ever, forever	ewig
ethanol	etanol
ethereal smell	eteriese reuk
Ethiopia	Ethiopië
Ethiopian	Ethiopiër
Etruria	Etrurië
Etrurian, Etruscan	Etruries
Etrurian, Etruscan	Etruriër
Etrurian, Etruscan	Etruskies
eucalyptus, bluegum	bloekom
Euphrates	Eufraat
Europe	Europa
European	Europeaan
European	Europees
European	Europeër
European, white man	blanke
European, white man	witmens
Eva	Eve
evaluation	evaluering
evaporate	verdamp
evaporation	verdamping
even	selfs
even though	altans
even, regular	reëlmatig
evening	aand
evening (news)paper	aandblad, aandkoerant
evening air	aandlug
evening class	aandklas
evening class	aandskool
evening gown	aandrok, aandtabberd
evening jacket	aandbaadjie
evening meal, supper	aandete
evening star	aandster
evening wear	aanddrag, aandkleding, aandklere, aandpak
evenings	aande
event, occasion, occurence, opportunity	insident
event, occasion, occurence, opportunity	voorval
event, occasion, occurence, opportunity, chance	gebeurtenis
evergreen	altydgroen
every kind of	allerhande
everyday	alledaags, alledaagse
everyone's	almal se
everyone, everybody	almal
everything	alles
evil spirits	bose geeste
exactly, sharp	presies
exaltation	verheerliking
examine, investigation, examination, test	ondersoek
example	voorbeeld
excavate	afgrawe
excavation	afgrawing
excellent	piekfyn
exceptional	uitsonderlik
excessive, inordinate, extreme	ekstreem
exchange, power station	sentrale
excitement	opwinding
exclamation mark	uitroepteken
exclude	uitsluit
exclusive	uitgesluit
exclusively, just, only, alone, solely	slegs
exclusively, just, only, alone, solely, exactly	net
excommunicate	ekskommunikeer
excommunication	ekskommunikasie
excursion, outing, sightseeing trip	uitstappie
excuse me	verskoon my
execute	uitvoer
executive secretary	uitvoerende sekretaris
exercise, practice	oefening
exercise, practise	oefen
exert, practice	beoefen
exhaust pipe	uitlaatpyp
exhaust stack	uitlaatstaanpyp (vragmotor)
exhaust valve	uitlaatklep
exhausted, used up	uitgeput
exhausting	afmattend, afmattende
exhibition, exposition	uitstalling
exile, banishment	ballingskap
exist	bestaan
exit, go out	uitgaan
Exodus	Eksodus
expenses	besteding
experience	ervaring
experience	ondervinding
experience, live through, survive	deurmaak
experienced	bedrewe
experienced, expert	ervare
experiment	eksperiment
explain, clarify	verduidelik
explanation	verduideliking
explode	ontplof
explosion	ontploffing
export	uitvoer
express	uitdruk
expression	uitdrukking
expression, face	gesig
extension	uitbreiding
extension (to building)	aanbouing, aanbousel
extensive, spacious, vast, wide	uitgestrek
exterior plate coating	buitedekking (verflaag)
exterminate, wipe out	uitroei
external modem	eksterne modem
extinguish, put out	blus
extinguish, put out	doodmaak
extra	ekstra
extra dry, extra sec	ekstra-droog
extract	ekstrak
fabricate, manufacture, do, make, perform	vervaardig
face	aangesig
facial nerve	aangesigsenuwee
facial paralysis	aangesigsverlamming
facilitate	fasiliteer
facilitate	fasiliteer 
facilitator	fasiliteerder
fact	feit
factory	fabriek
factory fitted	fabrieksgemonteerd
factory roof trellising	fabrieksdakstelsel
fade	verbleik
fade (n)	dower (radio)
fader control	dowerkontrole (radio)
fail	faal, nie plaasvind nie (koppeling), gebreek, onderbreek (verbinding)
faint, light, weak	swak
faint, swoon	flou word
fair	regverdig(e)
fair, just, righteous	billik
fair, just, righteous	regverdig
fairy	fee
faith	geloof
fall of man	val van die mens
fall off	afval
false	vals
family	familie
family	gesin
family home evening	gesinsaand
famous, glorious	beroemd
fan belt	waaierband
fancy, imagine	verbeeld hom
FAQ (Frequently Asked Questions)	kwelvrae, neulvrae, (FAQ)
far too much	alteveel
farewell	totsiens
farewell dinner	afskeiddinee, afskeidsdinee, afskeidsmaal, afskeidsmaaltyd
farewell party	afskeidpartytjie, afskeidspartytjie
farewell visit	afskeidbesoek, afskeidsbesoek
farewell, greet	groet
farewell, greetings, goodbye	afskeid
farm	plaas
farm butter	plaasbotter
farm implements	plaasgereedskap
farm life	plaaslewe
farm road	plaaspad
farmhouse	plaashuis
farms	plase
farmyard	plaaswerf
fartewell kiss	afskeidsoen
fascinate	fassineer
fashion, mode	mode
fast	vas
fast and testimony meeting	vas en getuienisbyeenkoms
fast forward	snel vorentoe (radio)
fast offering	vasoffer
fast sunday	vas-sondag
fast, quick, rapid, speedy, swift, quickly	vinnig
fast, quickly, swiftly	gou
fasten together, glue (v)	aaneenheg
fat, fatty, greasy	vetterig
fat, fatty, greasy, grease	vet
father	pa
father	pa, vader
father	vader
Father Christmas	Kersvader
fathom (v)	peil
fathomable	peilbaar, peilbare
fatty acid	vetsuur
favourites	gunstelinge
fax (facsimile)	faks (faksimilie)
fear	angs
fear	bangheid
fear	vrees
fearful	angstig
Feast of Tabernacles	Loofhuttefees
feather, pen	veer
February	Februarie
feces	ontlasting
feel	voel
feel, sense	voel
female, feminine	vroulik
fence trellising	heiningstelsel
ferment (v)	gis (ww)
ferment out	drooggis
ferment out	uitgis
fermentation	gisting
fermentation tanks	gistenke
fermented	uitgegis
fermenting yeast	bogistop
fertile	vrugbaar
fertiliser	bemesting
feudal	feodaal
fever	koors
feverish	koorsig
field	veld
field	veld (bv e-pos adresveld), veld (by databasis)
field(s)	terrein(e)
FIFO (first in, first out)	EIEU (eerste in, eerste uit)
fifteen	vyftien
fifth	vyfde
fifty	vyftig
fig	vy
fight	baklei
fight alongside	meeveg
fight, struggle	veg
file, line, rank, row, turn	tou
fill up	aanvul
fill, fill in, fill up	invul
fill, fill in, fill up	vol maak
filler hole	vul(ler)gat
filler neck	vullernek
filling wine	opvulwyn
film yeast	kimgis
film, motion picture, movie	film
film, motion picture, movie	prent
film, motion picture, movie	rolprent
filter pad	filterpapier
filtered	gefiltreer
filtration	filtrasie
final drive	eindaandrywing
final examination	eindeksamen
final judgement	eindoordeel
final rinse	finale afspoel
find fault	afkraak
find out	agterkom
fine	boete
fine (n)	afkoopboete
fine (v)	beboet
fine lees	fynmoer
fine, great, eminent	puik
fine, very well	uitstekend
finger	vinger
finish (v)	afhandel
finish one's studies	afstudeer
finished, ready, through	bereid
finished, ready, through	gereed
finishing school	afrondingsoord
Finland	Finland
Finn	Fin
Finn	Finlander
Finnish	Fins
fino sherry	finosjerrie, droë sjerrie
fir	denneboom
fir, pine, pine tree	den
fire	vuur
fire off	afvuur
firewall	vuurmuur, brandmuur (cmdp)
firm, robust, sturdy, solid	ferm
firm, robust, sturdy, solid	stewig
first	eerste
first aid	noodhulp
first counselor	eerste raadgewer
first leaf	eerste blad
first presidency	eerste presidensie
first quorum of seventy	eerste kworum van sewentig
first vision	eerste visioen
firstborn	eersgeborene
fish	vis
fish	visvang
fisherman	visser
fishing rod	hengel
fishy	visagtig
fist	vuis
fit (v), adapt	aanpas
fit, conform, fit in, be appropriate, suit	pas
fitting cubbilcle	aantrekhokkie, aantrekkamer
fitting room	aanpasvertrek
five	vyf
fix, repair	regmaak
flame	vlam
flame (n)(comp)	dondergram ('n hele boodskap), vuurskoot (frase of enkele sinne)
flame (v)(comp)	met vuur skiet, bliksem (minder formeel)
flame war	vlamoorlog, bliksemstryd
Flanders	Vlaandere
flare, flare up	flikker
flat	plat
flat (surface)	vlak, gelyk
flat (tyre, wine)	pap
flat-bottomed barge	platboomskuit
flat-headed nail	platkopspyker
flat-roofed house	platdakhuis
flatness	platheid
flattened, pressed flat	platgedruk, platgedrukte
flatter, valley	vlei
flavoured grape drink	gegeurde druifdrankie
flee, run away	vlug
Flemming	Vlaming
Flemmish	Vlaams
flesh	vleis
flesh tissue	vleisweefsel
flexibility	buigsaamheid
flimsy, weak, delicate	pieperig, pieperige
flinty taste	kruitsmaak
float, swim	swem
flock, herd	kudde
flock, herd	trop
flood	oorstroom
floor, storey, story	verdieping
flor	flor
floral	bloeisel
floral nose	bloeiselneus
floryeast	florgistend
flour	bakmeel
flour	meel
flow	stroom
flow	vloei
flow control	vloeibeheer, kommunikasiebeheer
flow, function, operate, run, work	loop
flower bouquet	blomboeket
flowerbud	blomknop
flowery aroma	blomaroma
flu, grip, influenza	griep
fluid, liquid	vloeistof
Flushing	Vlissingen
flute	fluit
fly wheel	vliegwiel
fly, housefly	vlieg
flying fox, fruit bat	piesangvlermuis
foam	skuim
foam, froth	skuim
focus (v.)	fokus (ww.)
focused (a.)	gefokus(te) (b.nw.)
fog, mist	mis
folder	vakkie, vouer
follow	agternasit
follow	upopvolg
follow	volg
follow, hunt, pursue	agtervolg
follower	aanhanger
followers	aanhangers
following (n)	aanhang
following, next	volgende
font	font, lettertipe
food, nourishment	voedsel
foolish, stupid	dom
foot, paw	voet
football, soccer	sokker
footrest	voetrus
for argument's sake	argumentshalwe
for the greater part, for the most part, mostly	merendeels
for, during, while, whilst	gedurende
for, during, while, whilst	terwyl
for, during, while, whilst	tydens
for, to, in order to	om te
forbidden fruit	verbode vrug
force (v)	forseer
force, strength, vigour	krag
force, strength, vigour, be allowed to, may	mag
forced lubrication	druksmering
forecourt	voorplein
foreground, close-up	voorgrond
forehead	voorkop
foreign country	buiteland
forest, woods	bos
forested	bebos
forget	vergeet
forgive, pardon	vergeef
form, shape	gedaante
form, shape, blank	vorm
formal	formeel
formal wear	balkostuum
format (n)	formaat
format (v)	formatteer
former, last, previous, prior, ex-	voormalige
former, last, previous, prior, ex-	vroeëre
fornication	hoerery
fortified wine	gefortifiseerde wyn, versterkte wyn
fortunate, happy	gelukkig
forty	veertig
forum	forum
forward slash	vorentoeskuinsstrepie (kyk ook wack)
fossil	fossiel
fountain, source, spring	bron
four	vier
four strand system	vierdraadstelsel
fourteen	veertien
fourth	vierde
foxy taste	wilde smaak
fragment, lump, piece, part, share, spare part	stuk
frames	rame, ruite, venters
France	Frankryk
Franconia	Frankeland
Frankish	Frankies
free	gratis
free	vry
free agency	vrye wil
free run, free run-off	vrye afloop
free running juice	vryloopsap
free-standing	alleenstaande
freedom	vryheid
freedom of the press	persvryheid
freeware	vryware
freeze	vries
freezer	vrieshok
French brandy	konjak
French, French language	Frans
French, French language	Franse taal
Frenchman	Fransman
frequency	frekwensie, gereeldheid (algemeen)
frequently, often, regularly	dikwels
fresh	vars
fresh water	vars water
fresh, recent	vars
Friday	Vrydag
friend	vriend
friend	vriendin
Friesland	Friesland
fripperies	tierlantyntjies
Frisian	Fries
frivolous	aanstellerig
from here, hence	hiervandaan
from there, thence	daarvandaan
from, out of	uit
from, out of	van ... af
from, since	vanaf
front bumper	stamper
front bumper	voorbuffer
front end	voor=
front footrest	voorste voetrus
front suspension torsion bar	voorveringtorsiestang
froth	skuim
frozen	bevrore
fruit	vrug
fruit acid	vrugtesuur
fruitbud	vrugknop
fruitiness	vrugtigheid
fruity	vrugtig
fry	braai
frying oil	bakolie
FTP (File Transfer Protocol)	FTP (Lêeroordragprotokol), LOP (minder algemeen gebruik)
ftp-site	ftp-werf
fuel	brandstof
fuel indicator	brandstofmeter
fuel injector pump	brandstofinspuit(ing(s))pomp
fuel system	brandstofstelsel
fuel tank	petroltenk
fuel tank capacity	tenkgrootte
full bodied	lywig
full wine	vol wyn
full-dipped	volle dompeling
full-stop	punt (.)
full-time	heeltyds
fullback	heelagter
fullness	volheid
fullness, body	lyf, volheid
fully sweet	volsoet
fun, pleasure	genot
fun, pleasure	plesier
function	funksie
function, operate, run, work, job	werk
fund	fonds
fungus infection	fungusbesmetting
fur	pels
fur coat	pelsjas
fur seal	pelsrob
fur seals	pelsrobbe
fur trade	pelshandel
fur trapper	pelsjagter
furlough, leave, pass	verlof
furniture	ameublement
furry creature	pelsdier
future	toekoms
future oriented	toekomsgerig(te)
FYI: (for your information:)	ter kennis van (by e-pos)
gable truss trellising	gewelstelsel
gadget, apparatus	apparaat
Gaelic, Celtic	Kelties
gain, profit	wins
Galician	Galicies
gallery	galery
galsterig	rancid
galvanised wire	bloudraad
games	speletjies
garage	garage
garage	motorhawe
garden	tuin
garden of eden	tuin van eden
gardening	tuinmaak
garlic	knoffel
gas, guest	gas
gasolene, gasoline, petrol	petrol
gateway	deurgangspoort (clc), toegangspoort, ingangspoort (meer akkuraat)
gathering of Israel	insameling van Israel
Gaul	Gallië
gaunt, lean, meager, skimpy, skinny, thin	maer
gaunt, lean, meager, skimpy, skinny, thin	skraal
gaunt, lean, slender, thin	dun
gazette, magazine, newspaper, periodical	koerant
gear-box, gear-case	ratkas
gearbox	ratkas
gearchange lever	rathefboom
gearchange lever	ratkierie
gearshift	ratkierieposisie
gecko	geitjie
geiger counter	geigerteller
gem, jewel	juweel
gender	geslag
genealogy	genealogie
general	generaal
general (a)	algemeen, algemene
general authority	algemene gesagdraer, algemene kerkleier
general, usual	algemeen
generalities, banalities	algemeenhede
generally	in die algemeen
generation	generasie
generation	geslag
generation, sex	geslag
Genesis	Genesis
Geneva	Geneve
Genoa	Genua
genre	genre
gentiles	nie-jode
gentle, soft, sweet, tender	soet
gentle, soft, sweet, tender, charming, lovely	lieflik
genuinely, indeed, really, truly	regtig
genuinely, indeed, really, truly, absolutely	darem
geographer	aardrykskundige
geographic, geographical	geografies
geographical	aardrykskundig
geography	aardrykskunde
geomagnetism	aardmagnetisme
geometrical	meetkundig
geometrist	meetkundige
geometry	meetkunde
geophysics	aardkunde
geranium	malva
German measles	Duitse masels
German measles	rooihond
German, German language	Duits
German, German language	Duitse taal
German, Teuton	Germaan
Germanic, Teutonic	Germaans
Germany	Duitsland
germinate	ontkiem
get cold	koud word
get dressed	aanklee
get lost	afdwaal
get out, get out of a car	afklim
get up, rise, stand, stand up, ascend, go up	opstaan
get, have, receive	bekom
get, have, receive	kry
get, have, receive	ontvang
get, lay hold of, pick up, take	oppik
get, lay hold of, pick up, take	optel
Ghent	Gent
gherkin	agurkie
ghetto	armbuurt
ghost, phantom	spook
giant	reus
gift of healing	gawe van gesondmaking
gift of the holy ghost	gawe van die heilige gees
gift of the interpretation of tongues	gawe van uitleg van tale
gift of tongues	gawe van die spreek in tale
gift, present	donasie
gift, present	geskenk
gigabyte	gigagreep
gin	jenewer
giraffe	kameelperd
girl	meisie, dogter
girl	meisie, meisiekind, meisiemens
girl's name	meisienaam
girl's' doubles (tennis)	meisiesdubbelspel
girl, lass	meisie
girlish	meisieagtig, meisieagtige
girls' school	meisieskool
girls' singles (tennis)	meisiesenkelspel
girls' wear	meisiesdrag
give	gee
give back, return	terugbesorg
give, pass, spend	aangee
give, present, hand over	aangee
gladness, joy	vreugde
glass	glas
glasses, spectacles	bril
gleaning	deurloop
glide, slip	gly
globe	aardbol
glory	heerlikheid
glove compartment	mossienes
glove compartment	paneelkassie
glove compartment	paneelkissie
glue (v)	plak
glue, stick, plate, sheet, slab, slice	plak
gnaw off	afknaag
gnu, wildebeest	wildebees
go astray, stray off	afdwaal
go down	afgaan
go fast, hurry, rush	gou maak
go for a walk, stroll	wandel
go on	aangaan
go on pension, retire	pensioeneer
go to the cinema, go to the movies	fliek
go with, assemble, congregate, gather, meet	saamgaan
go, shall, will	gaan
go, shall, will	sal
god the son	god die seun
goddaughter	peetdogter
godfather	peetpa, peetvader
godhead	die godheid
godmother	peetma, peetmoeder
godparent	peetouer
godson	peetseun
Gold Coast	Goudkus
gold, golden	goue
Golden Fleece	Gulde Vlies
golden plates	goue plate
golden yellow	goudgeel
goldfish	goudvis
golf, gulf	gholf
golf, gulf	golf
good afternoon	goeiemiddag
good afternoon	middag
Good afternoon!	Goeiemiddag!
good evening	goeienaand
good evening	naand
Good evening!	Goeienaand!
Good Friday	Goeie Vrydag
good morning	goeiemôre
Good morning!	Goeie môre!
good night	goeienag
good red wine	keur-rooiwyn
good, nice, okay, fine, very well	gaaf
good, nice, okay, OK, well	goed
goods, wares	ware
Gopher	Gopher
gospel	evangelie
gossip	klets
Gothic	Goties
Gouda	Gouda
gound clearance	grondvryhoogte
gourd, pumpkin, squash	pampoen
government	regering
grab handle	gryphandvatsel
grace	genade
grade down	afgradeer
gradually, little by little	stadigaan
graft	ent
graft joint, graft union	entlas
graft old vines	ou stokke afent
Grail	Graal
gram, gramme	gram
grammar	grammatika
granddad	oupa
granddaughter	kleindogter
grandfather, grandpa	oupa
grandmother, grandma	ouma
grandson	kleinkind
grandson	kleinseun
granite soil	granietgrond
granny	ouma
grant permission	toelating gee, toegang gee
grape	druif
grape	druif, korrel
grape drink	druifdrankie
grape mill	parsmasjien
grape residue	druifreste
grape sugar	druifsuiker, druiwesuiker
grape transport bin	druiwebak
grape-based drinks	druifbasisdranke
graphics	grafika
graphics card	grafikakaart
grass	gras
grass cut green	groen gesnyde gras
grass green	grasgroen
grave	gravis (bv è)
gravy, sauce	sous
gray, grey	grys
great-grandchild	agterkleinkind
great-grandfather, great-grandpa	oupagrootjie
great-grandmother, great-grandma	oumagrootjie
greater than	groter-as (>)
Greece	Griekeland
greed	heblus, hebsug
Greek	Griek
Greek, Hellenian, Hellenic	Grieks
green	groen
green beans	groenbone
green grape	groendruif
green olive	groen olyf
green shoot	groenloof
Greenland	Groenland
greet, salute, greeting	groet
greyed out	vergryste, mistige
griller	rooster
gripped, interested	geïnteresseerd
gross lees	dikmoer
ground	grond
ground electrode	aardelektrode
ground, soil	grond
guarantee, warrant	waarborg
guard	kondukteur
guest	gas
guideline document(s)	riglyndokument(e)
guideline(s)	riglyn(e)
guiltless, innocent	onskuldig
guilty	skuldig
Guinea	Guinee
gull	meeu
gun, cannon	kanon
gun, rifle	geweer
gutter	afvoergeut
gutter press, tabloid press	skandaalpers
gymnastics	gimnastiek
gypsum, plaster of Paris	gips
gypsy, Gypsy	sigeuner
habour patrol	hawepolisie
hacker	kapper (oppas, kyk cracker)
haemorhoids	aambeie
haemorrhoid, hemorrhoid, pile	aambei
hail	hael
hailing from	afkomstig uit
hair removal method	ontharingsmiddel
hair, hairs, hers	hare
hairdresser, female hairdresser	kapster
Haiti	Haïti
Hallo!	Hello!
halt, come to a halt, stop	gaan staan
halt, come to a halt, stop	stilhou
halt, stop	stop
hamburger	hamburger
hand	hand
hand, laborer, labourer, operative, worker	werker
handbook, guide, guidebook	gids
handbrake lever	handrem
handicraft, occupation, trade, profession	beroep
handle, manipulate	hanteer
handshake	bladskud (eerste kommunikasie tussen rekenaars)
hang	ophang
hang (v)	hang ('n netwerk)
hang onto, hold	behou
hang onto, hold	hou
hang onto, hold	vashou
harbor, harbour, port	hawe
harbour	hawe
harbourmaster	hawehoof
hardness	skerpheid
hardware	hardeware, apparatuur (formeel)
harmful, damaging, hazardous	skadelik, skadelike
harmless	skadeloos
harsh	grof
harvest	oes
harvest control	oesbeheer
harvest time	oestyd
hash	hemp (kappertaal), huts, pons (minder algemeen gebruik) (#)
haste, go fast, hurry, rush	haas
hat	hoed
hatchback	luikrug
hate	haat
Havana	Havanna
have faith, have faith in, trust, confide	vertrouwe stel in
have to, must, ought to, should	moet
have, have got	hê
Hawaii	Hawaiï
Hawaiian	Hawaïes
hawk	hawik
hay, straw	hooi, strooi
hazelnut	haselneut
he is	hy is
he, him	hy
head	kop, hoof
head board	koppaneel
head board	kopplank
head of the table	tafelkop
head, pate	kop
head-over-heels	afbeen
headache	hoofpyn
header	hofie, opskrif
header entry	opskrif (e-pos), opskrifaanduiding
headlamp bezel	kopliggleufring
headless	afkop
headlight	hooflig
headlight	koplamp
headlight	koplig
headlight housing shell	koplighuisie
headlight housing shell	kopligmontasie
headquarters	hoofkwartier
healings	gesondmakings
health	gesondheid
healthy, well	fiks
healthy, well	gesond
heap, pile, stack	klomp
hear, find out, learn of	hoor
hearing	gehoor
hearing aid	gehoorapparaat, gehoortoestel
hearing organ	gehoororgaan
hearing test	gehoortoets, gehoorvermoë
heart	hart
heat	hitte
heat exchanger	hitteruiler
heater control	hittebeheer
heater control	verwarmer(kontrole)
heath	heide
heaven	die hemel
heaven, sky	hemel
heavenly father	hemelse vader
heavy wine	swaar wyn
hebrew	hebreeus
Hebrew, Jew	Hebreër
Hebrew, Jew	Jood
Hebrew, Jew, Israelite	Israeliet
Hebrew, Jewish	Hebreeus
Hebrides, Western Islands	Hebride
hedges	hegge
hedonism	hedonisme
hegemony	hegemonie
height	hoogte
helderheid	clarity
hell	die hel
hell	hel
Hellenian, Hellenic	Helleens
hello	dag
hello	hallo
helmet	helm
Helvetia	Helvesië
Helvetia, Switzerland	Switserland
hemmorhoid, pile	aambei
her, his, its, their, she	haar
herbal wine	kruiewyn
herbal wines, apéritif wines	kruiewyne, aperitiefwyne
herbivores	plantvreters
herbivorous	plantetend, plantetende
herbs	kruie
here	hier
here, hither	hierheen
hero	held
heroic	heldhaftig
heroin	heroïen
heroine	heldin
hesitate	aarsel
hesitating	aarselend, aarselende
hesitation	aarseling
hex nut	seskantsluitmoer
hick, hilbillie, simpleton	plaasjapie
high priest	hoëpriester
high tension lead	hoëspanningsdraad
higher order thought process(es)	hoërorde-denkproses(se)
Highlander	Hooglander
highlight (n)	hooftrek
highlight (v)	belig, verlig, blok (teks)
hijacker	skaker
hijacking	skaking
him	hom
hind foot, back foot	agtervoet
hind leg	agterbeen
Hindu	Hindoe
Hindu, Hindoo	Hindoe
Hindu, Hindoo	Hindoe-
Hindu, Hindoo	Hindoes
Hinduism	Hindoeïsme
hinge	skarnier
hint, tip	wenk
hip	heup
hippo, hippopotamus	seekoei
hire	huur
his	syne
his, her, its, their, she	sy
history	geskiedenis
hit, knock, strike	klap
hoarse	hees
hockey	hokkie
holder, socket	houer
hole	gat
hole	lek
hole, ditch, pit	sloot
holiness	heiligheid
Holland	Holland
holy	heilig
holy ghost	heilige gees
home	huis toe
home button	tuisknoppie
home page	tuisblad
home storage	tuisopgaarding
homeless	haweloos
homogenous volume	homogene volume
honor, honour	huldig
honour	agbaarheid
honourable	agbaar, agbare
hooked nose	arendsneus
hooker, whore	hoer
hooter	toeter
hope	hoop
hope	hoop, hoopverwagtinge
horn	toeter
horn button	toeterknoppie
horrible	aaklig, aaklige
horrible	afgryslik, afgryslike
horrible	afskuwelik, afskuwelike
horrifying	afskuwekkend, afskuwekkende
horror	afgryse
horror	horror
horror (n)	afskuwelikheid
horrors	afskuwelikhede
horse breed	perderas
horse breeder	perdeboer
horse doctor, veterinarian, vet	perdedokter
horse hair mattress	perdehaarmatras
horse meat	perdevleis
horse races	perderenne, perdewedren
horse rider, equestrian	perderuiter, perdryer
horse sickness	perdesiekte
horse thief	perdedief
horse trader	perdehandelaar
horse's hoof	perdehoef
horse-drawn cart	perdekar, perdevoertuig, perdewa
horsefly	perdevlieg
horsehair	perdehaar
horsepower	perdekrag
horseriding	perdry
horses	perde
horsey	perdagtig
hose	slang
hospitable	gasvry
hospital	hospitaal
hospitalised	gehospitaliseer, gehospitaliseerde
hospitality	gasvryheid
host	gasheer
hostess	gasvrou
hostile	vyandelik
hot	warm
hot-headed	heetgebakerd, heetgebakerde, heethoofdig, heethoofdige
hotel	hotel
hothead	heethoof
hour, o'clock, time	uur
house	huis
house of israel	huis van israel
house of prayer	huis van gebed
houtaroma	wood nose
houtsmaak	wood taste
how are you?, how do you do?	hoe gaan dit met u?
how far	hoe ver
how many, how much	hoeveel
how many, what number	hoeveelste
how, in what way, as, like, such as	hoe
HTML (Hyper Text Markup Language)	HTML (Hiperteks-markeertaal)
HTML-tag	HTML-plaatjie, HTML-merker, HTML-grepie
HTTP (Hyper Text Transfer Protocol)	HTTP (Hiperteks-oordragprotokol)
hubcap	naafdop
hubcap	wieldop
hue, nuance, shade, tint	skakering
human	menslik
human judgment(s)	menslike beoordeling(s)
human resources manager	personeelbestuurder
humility	ootmoed
hundred, one hundred	honderd
Hungarian	Hongaar
Hungarian	Hongaars
hungry	honger
hunt line	jaglyn (van 'n ISP)
hunter	jager
hurried, fast, quick, rapid, speedy, swift	haastig
hurt	beseer
husband	eggenoot
husband	man
husk brandy	dop(pe)brandewyn
husk, skin	dop
hut	hut
hyaena, hyena	hiëna
hyaena, hyena	strandwolf
hydrogen sulfide	waterstofsulfaat
hygienic	higiënies
hyper-terminal	hiperterminaal
hyperlink	hiperskakel
hyphen	afkappingsteken, afkapteken
hypothesize, guess, presume, suppose, surmise	veronderstel
I am	ek is
I, me	ek
Iberian	Iberies
ice, icecream	ys
Iceland	Ysland
Icelander	Yslander
Icelandic	Yslands
icon	klikkie, ikoon
idea	idee
idea, concept, opinion	opvatting
ideal	ideaal
idiom	idioom
idle (n)	stil (telefoonlyn)
idol	afgod
idol	afgod, afgodsbeeld
idolater	afgoddienaar, afgodedienaar, afgodedienares (f)
idolatry	afgodediens
idolatry	afgodediens, afgodery
idols	afgode
if	as
if, provided that	indien
ignition	ontsteking
ignition key	aansitsleutel
ignition switch	ontstekerskakelaar
ignore	ignoreer
ill, sick	siek
illiteracy	analfabetisme
illiteracy	ongeletterdheid
Illiterate person	analfabeet
image, picture, statue	beeld
imagination	verbeelding
immature	onvolwasse
immeasurable	peilloos, peillose
immediate future	afsienbare toekoms
immigrate	immigreer
immorality	onsedelikheid
immortal	onsterflik
immortality	onsterflikheid
immune	onvatbaar
impious	piëteitloos
implicit (- criteria)	implisiet(e) (- kriteria)
imply, mean, signify	beteken
import	invoer
import tax	aksynsbelasting
important	allerbelangriks
important, serious	belangrik
important, serious	erg
important, serious	ernstig
impress	beïndruk
impressable, sensitive	sensitief
in any event	in elk geval
in arrears	agterstallig, agterstallige
in command	aanvoerend
in retrospect	agteraf
in short supply	karig
in single file, one behind the other	agtermekaar
in the evening	saans
in the morning	smôrens
in-line	in gelid
inactivated	verlam
inclined	geneig
including, inclusively	insluitend
inclusion	insluiting
inclusive	inklusiewe
incoming message	inkomende boodskap
increase in numbers	aanwas, aanwassing
incubate, sit	broei
indent (n)	inkeping
indent (v)	inkeep
indentation	inkeping
index	indeks
India	Indië
Indian	Indies
Indian	Indiër
Indian, American Indian	Indiaan
Indian, American Indian	Rooihuid
Indian, Red Indian	Indiaans
indicate	aandui
indicate	aantoon
indicate, point out, show, introduce, perform	vertoon
indicate, point out, show, toe, tone	toon
indicate, suggest, point out, show	aandui
indicator	aanduider
indicator light	flikkerlig
indicator switch	flikkerligarmpie
indicator switch	flikkerligskakelaar
individual	individueel
individual, personal	persoonlik
Indo-China	Agter-Indië
Indo-China	Indo-China
Indo-China	Indo-Sjina
Indo-European	Indo-Europeaan
Indo-European	Indo-Europeër
Indo-European, Indo-Germanic	Indo-Europees
Indo-European, Indo-Germanic	Indo-Germaans
Indonesia	Indonesië
Indonesian	Indonesies
Indonesian	Indonesiër
industrial dispute	arbeidsgeskil
industry	industrie
industry	nywerheid
infect	aansteek
infectiousaansteeklik, aansteeklike
inform, report	in kennis stel
information	informasie
information	inligting
information	inligting, informasie
information, communication	berig
information, communication	kennisgewing
inhale	inasem
inherit	erf
inhibit	inhibeer
initial	voorletter
initial lesson	aanvangsles
initial phase	aanloopfase
initially	aanvanklik, aanvanklike
initiation	ontgroening
inject	inspuit
injection	inspuiting
injury, wound	wond
inlet valve	inlaatklep
inline	inlyn
inner lining	binnevoering
inner pole	binnepaal
inoculation	inenting
input box	toevoerboks, toevoerkassie
inquiry-office	inligtingskantoor
inquisitive, curious	nuuskierig
insect disease	insekplaag
inspector	inspekteur
inspector	inspektisto
inspiration	inspirasie, ingewing
install	installeer
instant, moment	oomblik
instant, moment	rukkie
institute	inrigting
institute	instituut
instructor, teacher	onderwyser
instrument panel, dashboard	instrumentpaneel
insubordinate, rebellious	opstandig
insufficient	ontoereikend
insulation, isolation	isolasie
insurance	versekering
insure, assure, certify, make certain	verseker
integral part	integrerende deel
integrated	geïntegreerd
integration	integrasie
intelligence	intelligensie
intelligent, sagacious	intelligent
intense, intensive	intens
intention	bedoeling
intention, meaning, plan, design, diagram, plane	plan
interchange, swap	inruil
interchange, swap, turn	wissel
interest	belangstelling
interesting	interessant
interface	koppelvlak
interior door handle	binnedeurhandvatsel
interior door handle	binnedeurknip
interior door lock button	binnedeurslotknoppie
interior door lock button	deurslotknoppie
interior door lock button	gendelknoppie
intermediate phase	intermediêre fase
internal modem	interne modem
international	internasionaal
Internet	Internet (die groot internet)
internet	internet (teenoor intranet)
Internet account	Internetrekening
Internet Cloud	Internetwolk
internode	internodium
interpret	vertolk
interpretation	vertolking
interrupt (IRQ)	onderbrekingsversoek (clc) (IRQ)
interview	onderhoud
intravenous feeding	aarvoeding
introduce, perform, present	bekendstel
introduce, perform, present, offer, proposal	voorstel
introduction, preface	inleiding
intuition	aanvoeling
invalid	ongeldig, verkeerd, onaanvaarbaar
invent	uitvind
investigation, examination, test	eksamen
investigation, examination, test, exploration	navorsing
invitation	uitnodiging
invite	uitnooi
involve (v.)	behels, betrek
iodised	gejodeer, gejodeerd, gejodeerde
Ionian	Ionies
IP-number	IP-nommer, IP-adres
Irak, Iraq	Irak
Iraki, Iraqi, Iraquian	Iraaks
Iraki, Iraqi, Iraquian	Irakiër
Iran	Iran
Iran	Persië
Iranian	Iranies
Iranian	Iraniër
irc (internet relay chat)	irc (internet-aflosgesels)
Ireland	Ierland
irigation	besproeiing
Irish	Iers
Irishman	Ier
iron	yster
irrelevant, unsuitable	ontoepaslik
Islam	Mohammedanisme
Islamic	Islamities
Islamic	Mohammedaans
Islamic, Malay	Slams
island	eiland
isn't it, isn't that so, or not	nè
isolate (v)	afsonder
isolation	afsondering
ISP (internet service provider)	ISP (internetdiensverskaffer), IDV (minder algemeen
Israelian	Israeli
Israelian	Israelies
Israelite, Israelitish	Israelities
issue (n.)	kwessie, aangeleentheid
issue, proclaim, promulgate, publish, reveal	afkondig
Istanbul	Istanboel
Istanbul	Konstantinopel
Italian	Italiaan
Italian	Italiaans
Italian	Italianer
Italian (n)	Italianer
italic	skuinsdruk
Italy	Italië
ivory	ivoor
jackal	jakkals
jam, jelly (US), preserve	konfyt
Jamaica	Jamaika
January	Januarie
Japan	Japan
Japanese	Japanees
Japanese	Japannees
Japanese	Japanner
Japanese	Japans
Java	Java
Java script	Java teks (teks van 'n Java program), Java skrif (werkteks van 'n Javascript
Javan, Javanese	Javaans
Javanese	Javaan
Javascript	Javascript (naam van skriptaal)
jealous	jaloers
Jehovah	Jehova
Jehovah, Yahweh	Jahwê, Jehova
jerepigo	jerepiko
Jerusalem	Jerusalem
jew	jood
jeweller	juwelier
Jewish	Joods
job, assigned job, task	taak
job, work	arbeid
Johannesburg	Johannesburg
Johnny dunce, simple simon	jan pampoen
join	toetree tot
join, associate, come together, pool	aansluit
joining, junction	aansluiting
Jordan	Jordaan
Joseph	Josef
journalist	joernalis
judge, judgment	oordeel
judgment(s)	beoordeling(s), oordeel
jug, pot, box, container, vessel	pot
juice, sap	sap
July	Julie
jump off	afspring
jump, leap	sprong
June	Junie
juniper berry	jenewerbessie
juniper essence	jeneweressens
junk mail	gemorspos
jurisprudence, law, right, true, correct, exact	reg
jurist, lawyer	prokureur
just, just now	nou net
just, just now	so net
justice	geregtigheid
justice, righteousness	geregtigheid
kangaroo	kangeroe
karma	karma
keep track	hou tred van
keepsake, memento, souvenir	aandenking
keg	vaatjie
Kenya	Kenia
kerbs	randstene
kerosene, paraffin	lampolie, parafien
key, wrench	sleutel
keys of the priesthood	sleutels van die priesterskap
keyword	sleutelwoord
kick	skop
kick (v)	skop
kidney	nier
kill (v)	vermoor (geselskanale), stop (programprosedure)
kilo	kilogram
kilometer, kilometre	kilometer
kind, sort	soort
kindle, light	aan die brand steek
kindness	vriendelikheid
king pin	krinkspil
kingdom of god	koninkryk van god
kiss	soen
kiss, coast, seaside, shore	kus
kit	stel
kitchen	kombuis
kitchen sink	afwasbak
knee	knie
knock on (door)	aanklop
knocked out	platgeslaan, platgeslane
knockout punch	barshou
knot, node	knoop
know, know how	weet
Kremlin	Kremlin
Krishna	Krisjna
label	etiket
labour	arbei (ww), arbeid (s.nw)
labour colony	arbeidskolonie
labour day, workers' day	arbeidsdag
labour government	arbeidersregering
labour law	arbeidsreg
labour legislation	arbeidswetgewing
labour market	arbeidsmark
labour movement	arbeidersbeweging
labour organisation	arbeidersorganisasie
labour pains	barensnood, barenswee, barensweë
labour party	arbeidersparty
labour source	arbeidsbron
labour-intensive	arbeidintensief, arbeidintensiewe
labourer	arbeider
labourer's cottage	arbeiderswoning
lack of space	plaasgebrek
lactic	melkagtig
lactic acid	melksuur
lactic acid	melksuuragtig
lamb	lam
lamb	skaaplam
lamp	lamp
LAN (local area network)	LAN (plaaslike netwerk)
land (v)	aanland
landscape, scenery	landskap
language, tongue	taal
Lapland	Lapland
Laplander, Lapp	Lap
Laplander, Lapp	Laplander
Lapp, Lappish	Laplands
larch	lork
larch	lorkboom
large oak vats	stukvate
last	afgelope
last	laaste
last days	laaste dae
late afternoon	agtermiddag, agtermiddags
late harvest	laatoes
later	aanstons
later, later on, afterwards, next, subsequently	later
lateral offshoot	syloot
lateral roots	sywortels
Latin	Latyn
Latin	Latyns
latter-day saints	heiliges van die laaste dae
Latvia	Letland
Latvian, Lett	Let
Latvian, Lettish	Lets
laugh	lag
launch	lanseer, uitgee ('n produk), laai ('n applikasie)
laurel	lourier
law	wet
law of chastity	wet van kuisheid, kuisheidswet
law of consecration	wet van wyding, wydingswet
lawsuit, process	proses
lay down, place, put, put down, sit	sit
layer	laag
layman	leek
layout	uitleg
lazy, slothful, sound	lui
LCD	VKV (radio)
LCD	vloeikristalvertoon (radio)
LCD indication	LCD-wyser (radio)
leader	leier
leaflet, pamphlet, paperback	brosjure
leakage	uitlekking
lean back	agteroorleun
lean-to	afdak
learn	aanleer
learner	leerder
learning achievement(s)	leerprestasie(s)
leased line	gehuurde lyn
least	minste
leather goods	leerware
leave behind	agterlaat
Lebanon	Libanon
lector, lecturer	lektor
lees	afsaksel, moer
lees brandy	moerbrandewyn
left, left side	linkerkant
leg, paw	been
leg, paw, foot	poot
legacy	nalatenskap
legend	legende
legitimacy	legitimiteit
legume	peulgewas, peulplant, peulvrug
Leiden, Leyden	Leiden
lemon juice	suurlemoensap
lend	uitleen
length	lengte
leopard	luiperd
leopard, tiger	tier
leper	melaatse
leprosy	melaatsheid
less	minder
lesser than	kleiner-as (<)
lesson	les
letter	brief
letter of appointment	aanstellingsbrief
letter of recommendation	aanbevelingsbrief
letter of request	aanvraagbrief
letter of resignation	bedankingsbrief
lettuce	blaarslaai
lettuce	kropslaai
level (n)	peil
level of purity	suiwerheidsvlak, suiwerheidsgraad
level(s)	vlak(ke)
levels	peile
lever	hefboom
lever	hefboom, hefboomarm
lever, lift, raise	optrek
leverage	hefboomkrag, hefboommag, hefboomwerking
liable	skadepligtig
Liberia	Liberië
library	biblioteek
Libya	Libië
Libyan	Libies
Libyan	Libiër
licence	lisensie
licorice anise	dropanys
life	lewe
life context	leefwêreld
life skills	lewensvaardighede
lifting ability	hefvermoë
light	lig
light green	liggroen
light of Christ	lig van Christus
lighter (n)	aansteker
lightnesS	ligtheid
lily	lelie
lime-tree, linden-tree	lindeboom
limit	perk
limits	perke
limousine	limousine
limpid	helder
line	lyn
lineage, origin	herkoms
linguist	linguïs
linguistic	linguïsties
link(s)	verband(e)
links	skakels
Linux	Linux
lion	leeu
liqueur	likeur
Lisbon	Lissabon
list box	lysboks
listen	luister
listen	luister naar
listen to	aanhoor
listener	aanhoorder
liter, litre	liter
literacy	geletterdheid
literary output	pennevrug
literature	letterkunde
literature	literatuur
Lithuania	Litaue
Lithuanian	Litauer
Lithuanian	Litaus
little	min
little boy	pikkie
little crack	barsie
little farm	plasie
little horse	perdjie
little peach	persketjie
little pear	peertjie
little pen	pennetjie
little plan	plannetjie
little plant	plantjie
little saucer	pierinkie
little, few	min
liver, deliver, furnish, supply	lewer
livestock	vee
living room, living-room, sitting room	sitkamer
Livonia	Lyfland
Livonian	Lyflands
lizard	akkedis
lizard-like	akkedisagtig, akkedisagtige
Liège	Luik
loan	lening
local	plaaslik
local	plaaslik, plaaslike
location	lokasie
lock	stuiter (stuur)
lock-up	sluitrat (tipe ratkas)
log file	staaflêer, loglêer
log in	aanmeld, inteken
log out	afmeld (kyk log in), uitteken
logging	stawing, boekstawing
logical	logies
login name	aanmeldnaam
login script	aanmeldskrif
London	Londen
lonely, solitary	eensaam
long	lang
loof at, behold, gaze upon	aankyk
look for, seek	soek
lord	heer
lord	here
lord of hosts	here van die leërskare
Lorraine, Lothringen	Lotaringe
lorry, truck	vragmotor
lose	verloor
lose one's way	verdwaal
loss	verlies
loss of hearing	gehoorverlies
loud	hard
love	liefhê
lovely, bright, brilliant	pragtig
lovely, fine, great, delicious	kostelik
lover	geliefde
Low German	Nederduits
lower deck	onderdek
lower deck	onderste dek (kyk upper deck)
lowercase	onderkas
lubrication system	smeerstelsel
Lucerne	Lusern
lucifer	lucifer, môrester
Lucifer, Satan	Lucifer
Lucifer, Satan	Satan
luck, happiness	geluk
luggage	bagasie
luggage rack	bagasierak
luggage rack	baggasierak
luggage rack	dakrak
lumbar	lendesteun
lung	long
lurk	uitkyk, skuil, hurk
lush	geil
luxury	weeldeartikel
lyric, text	teks
Macedonia	Macedonië
maceration	deurdrenking, maserasie
Machiavelli	Machiavelli
Madagascar	Madagaskar
Madonna	Madonna
Madonna	Moedermaagd
Madrid	Madrid
maid, servant	bediende
mail box	posbus
mail list	poslys
mailbase	poslys, poslysbasis, poslysdatabasis
mailbox	posbus
mailing list	poslys
main shoot	hoofloot
maintain	argumenteer
maisonette	skakelhuis
major road	hoofweg
make an appointment, arrange to meet	afspreek
make up	grimeer
make up, make-up	grimering
Malacca	Malakka
Malay	Maleis
male, masculine	manlik
malolactic fermentation	appelmelksuurgisting
Malta	Malta
Maltese	Maltees
Maltese	Malteser
maltic acid	appelsuur
mammal	soogdier
mammary gland	melkklier
man, human being	mens
man, human being	mensekind
manager, director	bestuurder
Manchuria	Mantsjoerye
mango	mango
mango	veselperske
manner, mode, way	wyse
manner, mode, way, melody, tune, indicate	wys
manual	hand=
manual tuning	handinstelling (radio)
manually	self (pas liewer die sin aan)
many	baie
many, much	baie
map	kaart
marble (toy)	albaster
March	Maart
march, walk	stap
marine engineer	hawe-ingenieur
mark	afsteek
mark	merk, afmerk
mark	seël
mark, sign, signal, token, character	teken
marker	merker
marriage, matrimony	huwelik
married	getroud
married (a)	gehude
marry, be married, get married	trou
marvel, marvel at, wonder	verbaas hom
Mary	Maria
mask	masker
master race	heersersras, heersersvolk
master's degree	meestersgraad
masterpiece	meesterstuk, meesterwerk
mastery	meesterskap
match	vuurhoutjie
material	materieel
mathematical	wiskundig
mathematics	wiskunde
maturation	veroudering
mature, ripe	ryp
maturity	rypheid
Mauretanian, Moorish, Moresque	Moors
Mauritanian, Moor	Moor
maximum	maksimum
May	Mei
may (month)	mei, meimaand
may day	meidag
may day procession	meidagbetoging, meidagviering
maybe, perhaps, possibly	miskien
mayflower	meiblom
me, to me, I, my	my
meal	ete
meal	maaltyd
Mealtime	skaftyd
mean (v)	bedoel
meander, twist, wind around	kronkel
meaning	betekenis
meaningful	betekenisvol(le)
meant	bedoelde
measurable	meetbaar
measure	afmeet
measure	meet
measuring instrument	meetinstrument
measuring tape	meetband
mechanic	meganikus
mechanic	werktuigkundige
mechanical	meganies, meganiese
mechanics (abstract)	meganika
mechanics (people)	meganici, meganikusse
mechanisation	meganisasie, meganisering
mechanise	meganiseer
mechanism	meganisme
mediator	middelaar
medical	medies
medium dry sherry	mediumdroog sjerrie
meet	ontmoet
meet, pick up	oplaai
meeting	ontmoeting
meeting, assemblage, gathering	vergadering
megalith	megaliet
megalomania	megalomanie
megaphone	megafoon
melancholic	melancholies, melancholiese
Melanesia	Melanesië
Melanesian	Melanesies
Melanesian	Melanesiër
melanoma	melanoom
melchizedec priesthood (authority)	melgisedekse priesterskap
melchizedec priesthood (bearers of)	melgisedekse priesterorde
mellowing	versagting
mellowness	sagtheid
melody, tune	wysie
member	lid
member of the church [members]	lidmaat van die kerk [lidmate]
member, supporter, limb	lid
membership	lidmaatskap
memento	aandenking
mementos	aandenkinge, aandenkings
memory, recollection	herinnering
men	adamsgeslag
menace, threat	bedreiging
menace, threat	dreigement
menace, threaten	bedreig
mendicant order	bedelorde
menthol	mentol
mention	vermeld
mention (n)	melding
mention (v)	meld
mention, call	noem
mentionable	meldenswaardig, meldenswaardige
menu	kieslys
menu	spyskaart
merchant, businessman	handelaar
merchant, businessman	sakeman
mercy	genade
message	boodskap
message filtering	boodskapfiltering
message window	boodskapruitjie, boodskapventer
messiah	die messias
metallic paint	metaalverf
meter, metre	meter
methyl anthranilate	metiel antraniliet
metropolis, capital, capital city	hoofstad
Mexican	Mexikaans
Mexico	Mexiko
microbes	mikrobes
microbiological	mikrobiologies
middle ages	middeleeue
Middle East	Middel-Ooste
middleclass citizen, hamburger	burger
MIDI	MIDI
migrate, roam, wander, wander about	swerf
milch cow	melkkoei
milch goat	melkbok
mile	myl
milk bar	melkkroeg, melksalon
milk bottle	melkbottel
milk pail	melkemmer
milk teeth	melkgebit
milk tooth	melktand
milk-beard	melkbaard
milky	melkagtig, melkagtige, melkerig, melkerige
milky way galaxy	melkwegstelsel
millennium	millennium, duisendjarige vrederyk
millimeter, millimetre	millimeter
million	miljoen
MIME	MIME
mine	myn
mine	myne
mineral	mineraal
minimum	minimum
mining	mynbou
minister	minister
mint	ment
mint oil	pepermentolie
minus sign	aftrekteken
minute	minuut
minutes, protocol	boetekaartjie
miracle	wonder
miracle	wonderwerk
miraculous, amazing, astonishing, wonderful	wonderbaarlik
mirror	spieëltjie
mirror (v)	afspieël
mirror image	afspieëling
miss	mej, mejuffrou
mission	sending
missionary work	sendingwerk
mixed grill	allegaartjie
mixer	mengeldrank
mode	gang
mode	modus (radio)
model	model
model, pattern, scheme	skema
modem (modulator-demodulator)	modem (modulator-demodulator)
moderate, reasonable	matig
moderated	gemodereer
moderatio	nmoderering
modern	modern
modulation	modulasie
molar	agtertand
molasses	swartstroop, melasse
moldy	skimmelagtig
moldy cork	skimmelkurk
moldy taste	mufsmaak
mole	mol
molehill	molshoop, molshopie
Monday	Maandag
money	geld
money order	poswissel
Mongol, Mongolian	Mongool
Mongolia	Mongolië
Mongolian	Mongools
monitor (v.)	moniteer (ww.)
monitor(s) (n.)	monitor(s) (s.nw.)
monitoring	monitering
monk	monnik
monkey cage	apehok
monopoly	alleenhandel
monster, sample, specimen	monster
Montenegrin	Montenegryn
Montenegrin	Montenegryns
Montenegro	Montenegro
month	maand
monument	monument
moral	moreel
more, further	meer
Moroccan	Marokkaan
Moroccan	Marokkaans
Morocco	Marokko
morphology, accidence	morfologie
morsel, mouthful	hap
mortality	sterflikheid
Moscow	Moskou
most	meeste
most desperately required	allernodigs, allernodigste
motel	motel
moth	mot
moth	nagvlinder
mother	ma
mother	ma, moeder
mother of vinegar	asynkim
mother-of-pearl	perlemoer
motor road, motorway, super highway, turnpike	deurpad
motor-cyclist	motorfietsryer
motorbike	motorfiets
motorbike, moped	bromfiets
mould (art)	afgietsel
mountain	berg
mouse button	muisknoppie
mousey	muisagtig
mouth	mond
move	beweeg
move	verhuis
move (v)	verskuif
move, stir, affect	aangry
move, transfer	verplaas
movement	beweging
mow down	afmaai
Mozambique	Mosambiek
mudflap	modderflap
mudflap	modderklap
mudflap	modderskerm
mulatto	kleurling
mulch	deklaag
multimedia	multimedia
multiple recipient	meervoudige ontvangers
multiple strategies	veelvuldige strategieë
munition, ammunition	ammunisie
murderer	moordenaar
muscadel	muskadel
Muscat	muskaat
Muscat d'alexandrie	hanepoot
Muscovite	Moskowiet
museum	museum
mushroom	sampioen
musical instrument	musiekinstrument
Muslim	Moslim
must (n)	mos
must (v)	moet
mutineer, rebel	rebel
mutli-user	veelvoudige gebruiker
myself	myself
myth	mite
nail	nael
nail-varnish	naelpolitoer
name server	naambediener
namely, viz.	naamlik
Namibia	Namibië
napkin	servette
narcotic	verdowingsmiddel
narrative, story, tale	storie
nasalising mark	nasaleringmerk (bv ñ)
nasty, ugly	lelik
Natal	Natal
national	nasionaal
nationality	nasionaliteit
natural sciences	natuurwetenskappe
natural wine	natuurlike wyn
naturally	van nature
nature	natuur
nature of	aard
nauseous	aardig
navigate	navigeer, rondsoek, snuffel
Ndebele	Ndebele
nearby	langsaan
nearer	nader
nearest, next	naaste
nearest, next, close, nearby	eerskomende
neat	skoon
necessary	nodig
neck	hals
neck	nek
need, require	nodig hê
needs (n.)	behoeftes
negative plate	negatiewe plaat
negative plate group	negatiewe plaatgroep
negative terminal	negatiewe terminaal
neglect (n), shoddy work	afskeepwerk
neglect (v)	afskeep
negotiation	bedinging
Negro	swarte
neighbor, neighbour	buurman
nephew	neef
nest of vipers	addergebroedsel
nested structure	boomstruktuur
net	net (internetwerk)
netiquette	netiket
netmask	netmasker
network	netwerk
networking	netwerkwerk
networking layer	netwerklaag
New South Wales	Nieu-Suid-Wallis
new testament	nuwe testament
new wine	jongwyn
New Year's Day	Nuwejaarsdag
New zealand	nieu-seeland
new, novel	nuut
newbie	nuweling, groentjie
news, novelty, something new	nuus
newsgroup	nuusgroep
newsreader	nuusleesprogram, nuusleser
next, -to be	aanstaande
Nguni	Nguni
nibble	peusel
nibble off	afknabbel, afknibbel
nice, tasty	smaaklik
nickname	pennaam, alias
niece	niggie
Nigeria	Nigeria
night	nag
night club, night spot	nagklub
night light	bedlamp, bedlampie
night-stand, bedside table	bedkassie
nightgown	aandhemp
nine	nege
nineteen	negentien
ninety	negentig
NNTP (Network News Transfer Protocol)	NNTP (Netwerknuus-oordragprotokol)
no, not	nee
nobility, aristocracy	adel, adeldom, adellikes, adelstand
noble metal	edelmetaal
noble rot, botrytis	edelvrot, botritis
noble variety	edelvariëteit
noble wines	edelwyne
noble, aristocratic	adellik, adellike
nobody, no-one	niemand nie
node	oog
nodes	knope
nodes	nodiums
noise (in a message)	strooi, geraas
noise (in a newsgroup)	gemors, strooi, geraas
noise (on a line)	geraas
noise reduction	geraasvermindering (radio)
non-racial	nierassig
non-racist	nierassisties
non-sexist	nieseksisties
non-sparkling wine	niebruisende wyn, stilwyn
non-turbo charged rallying	nieaangejaagde veldren
nonconformist	andersdenkende
none	geen
norm, standard	standaard
normal	normaal
North America	Noord-Amerika
northern	noordelik
Norway	Noorweë
Norwegian	Noor
Norwegian	Noors
Norwegian	Noorweegs
Norwegian	Noorweër
nose	neus
not at all	glad nie
not do well in life	agteruitboer
not yet	nog niet
notch grafting	kloofenting
note (n)	aantekening
notebook	aantekenboekie, aantekeningboek, aantekeningsboek
notes	aantekeninge, aantekenings
nothing	niks nie
nothing, none	niks
notice	merk
notice	opmerk
noticeable, remarkable	aanmerklik, aanmerklike
notification, notice, advice, counsel	advies
November	November
novice	nuweling
nowhere	nêrens nie
nudity (esp male)	adamsgewaad, adamsklere, adamskostuum, adamspak, adamsvy, adamsvyg
number of	aantal
number, numeral	nommer
numeracy	gesyferdheid
nurse	verpleegster
nurse, sister	suster
nursery school	kleuterskool
nutty	neutagtig
nyala	basterkoedoe
oak	akker, akkerboom
oak	akkerhout, eikehout
oak	eik
oak vats	eikehoutvaatjies
oak vats, large	stukvate
oaks	akkerbome
oat straw	hawerhooi
oath of office	ampseed
oatmeal	hawermout
oatmeal porridge	hawermoutpap
oats	hawer
obedient	gehoorsaam
oblique, slanting	skeef
observable	waarneembaar (...bare)
observation, remark, notice	opmerking
occasion, time	maal
occasion, time, halt, stop	keer
occur	plaasvind
occured	plaasgevind
ocean	oseaan
octagon	aghoek
octagon	agthoek
octagonal	aghoekig, aghoekige
octagonal	agthoekig, agthoekige
October	Oktober
odd, peculiar, strange, typical	eienaardig
odometer	afstandmeter
odometer	odometer
odor, odour, scent, smell	geur
odor, odour, scent, smell	reuk
Oesjaarport	bottled vintage port
of course, natural, naturally	natuurlik
of noble birth	edel
off, down	af
off-dry	halfdroog
off-line	ongekoppel
offal	afval
offer	aanbod
offer (n)	aanbieding
offer, propose, suggest	bied
offered, proffered (a)	aangebode
office (priesthood)	amp
office, bureau	kantoor
office-holder	plaasbekleder
official	amptelik
official	beampte
official	offisieel
official (a)	amptelik, amptelike
official (n)	ampbekleder, ampsbekleder, ampsbekleër, ampsdraer
official (n), bureaucrat	amptenaar
official dress, uniform	ampsgewaad
official duties	ampspligte
official guard	ampswag
official residence	ampswoning
official robes	ampsklede
official seal	ampseël
official secret	ampsgeheim
official transport, company car	ampsmotor
official trip, junket	ampsreis
official visit	ampsbesoek
officialdom, bureaucracy	amptenaredom, amptenary
often	baiekeer, baiemaal
oh	ach
oh	o
OHC	bonokas
oil	olie
oil dip	oliemaat (kyk ook dipstick)
oil dip	olieskep
oil drain plug	olieaftapprop
oil drain plug	oliedreineer(ing(s))prop
oil filter	oliefilter
oil indicator/ guage	oliemeter
old	oud
old testament	ou testament
old-fashioned, out of date	ouderwets
old-fashioned, out of date	oudmodies
old-fashioned, out of date	outyds
oloroso	oloroso, halfsoet sjerrie
omega support	omegastut
omniscience	alwetendheid
omnivore	alleseter
omnivores	alleseters
omnivorous	allesetend, allesetende
on	aan
on foot	te voet
on the contrary	inteendeel
on the left, to the left	links
on the other side	anderkant
on the right, to the right	regs
on top of	boonop
on-line	gekoppel
once again	al weer
one	een
one-and-a-half	anderhalf, anderhalwe
one-armed	afarm
ongoing (- process)	voortgaan(de) (- proses)
onion	ui
only begotten	eniggeborene
only begotten son	eniggebore seun
open	oop
open secret	allemansgeheim
open, open up	oopmaak
opening bowler	aanvangsbouler
opening prayer	aanvangsgebed
opening vent	lugopening
opening vent	ventilasieopening
openly	openlik
opera	opera
operate	opereer
operation, surgical operation	operasie
opinion	mening
opinion	opinie
opinion	visie
opposite	oorkant
optimise	optimeer, optimaliseer
optimising	optimering, optimalisering
option	opsie
optional	opsioneel, bykomstig
or	of
orange	lemoen
Orange	Oranje
orange blossom	lemoenbloeisel
Orange Free State	Oranje-Vrystaat
orange-coloured	oranje
orbit	aardbaan, aardebaan
orbit	planetebaan
orchard	boord
orchestra	orkes
orchid	orgidee
ordain to the priesthood	tot die priesterskap orden
order	bestelling
order	orde
ordinance	ordinansie
ordinarily, usually	gewoonlik
ordination	ordening
organization	organisasie
organize	organiseer
orphan	ouerloos
orphan	weeskind
ostrich	volstruis
other, another, else	ander
others	andere
otherwise	anders
ouch	ai
ours	ons s'n
outboard moter	aanhangmotor
outbox	uitboks
outcome(s)	uitkoms(tes)
outer darkness	buitenste duisternis
outgoing message	uitgaande boodskap
outgrow	ontgroei
outlet	uitlaat
outside, outside of	buite
oven	bakoond
overall, total	totaal
overflowing, superfluous	oortollig
overhaul, overtake, pass	verbysteek
overrider	stamperskoen
oversteer	oorstuur
overwelming	oorweldigend
owe, debt	skuld
own, personal	eie
own, possess, possession	besit
owner	eienaar
owner's manual	eienaarshandleiding
oxidation	oksidasie
oxidised	geoksideer
pack	pakket
pack, package, wrap up	pak
package	pakket (verskillende programme saam)
packet	pakkie
packet vector	pakkievektor
packet, parcel	pakkie
page	bladsy
pain, pine, pine tree	pyn
painful	seer
paint supply tank	verftoevoertenk
painting, picture	skildery
pair off	afpaar
pale dry	bleekdroog
papaya, papaw	papaja
paper money, bill	bankbiljet, banknoot
papery	papieragtig
paradigm	paradigma
paradigm shift	paradigmaskuif, paradigmaverskuiwing
parallel port	parallelle poort
parchment	perkament
parchment paper	perkamentpapier
parchment scroll	perkamentrol
parchment-like	perkamentagtig, perkamentagtige
parchments	perkamente
parent	ouer
parental (- involvement)	ouer- (...betrokkenheid)
parents	ouers
Paris	Parys
parity	pariteit
park	parkeer
parrot	papegaai
parse	ontleed
parsley	pietersielie
part, piece, share	deel
part, piece, share	gedeelte
part, role, rôle	rol
partial name	broknaam
partially, partly	deels
partially, partly	gedeeltelik
participate, take part	deelneem
particular, special	spesiaal
parting words	afskeidswoord
partition (n)	afskeiding
partition (n)	afskorting
partition (v)	afskort
partition wall	afskeidingsmuur
pass away, die, expire	sterf
pass on	aangee
pass the sacrament	uitdeel van die nagmaal
pass, pass by	verbykom
pass, pass by, overtake	verbygaan
pass, spend	deurbring
pass, spend, convey, hand, hand over	oordra
passenger	passasier
passer-by	verbyganger
passwor	dwagwoord, toegangswoord, paswoord (minder algemeen gebruik)
past, last	verlede
paste	plak
pasteurisation	pasteurisasie
pastor	dominee
pastor, preacher	predikant
pasty wine	dikwyn
path	wandelpad
patience	geduld
patient	geduldig
patriarch	patriarg
patriarchal blessing	patriargale seën
patten	stutyster
pattern, stencil, template, templet	patroon
pauper's funeral	armebegrafnis
pavement, sidewalk	trottoir
pavilion	pawiljoen
pawn	pion
pawn, soldier	soldaat
pawns	pionne
pay	betaal
pay attention to	inrig vir
pay attention, watch out for, be careful	oppas
pay off	afbetaal
payment	afbetaling
pea	ertjie
peace	vrede
peaceful, peaceloving	vreedsaam
peach blossom	perskebloeisel
peach brandy	perskebrandewyn, perskelikeur
peach jam	perskekonfyt
peach pip	perskepit
peach tree	perskeboom
peach-coloured	perskekleur
peaches	perskes
peak	piek
peaks	pieke
peanut	aardboontjie
peanut butter	grondboontjiebotter
pear harvest	peeroes
pear tree	peerboom
pear-shaped	peervormig, peervormige
pearl of great price	baie kosbare pêrel
pears	pere
pecan	pekan
pecan nut	pekanneut
pecan tree	pekanboom
pectin	pektien, pektine
pedagogical	pedagogies, pedagogiese
pedagogical theory	pedagogiekteorie
pedagogue	pedagoog
pedagogues	pedagoë
pedagogy	pedagogie, pedagogiek
pedals	pedale
pedant	pedant
pedantic	pedanties, pedantiese
pedants	pedante
pederast	pederas
pederastie	pederastie
pederasts	pederaste
pediatrical	pediatries, pediatriese
pediatrist	pediater
pediatrists	pediaters
pediatry	pediatrie
pedicure	pedikuur
pediment	pediment
pedofilia	pedofilie
peel (v)	afskil
peel off	afdop
Peiping, Peking	Peking
pejorative (a)	pejoratief, pejoratiewe
pekinese	pekinees (b.nw, s.nw), pekinese (b.nw)
pelagic	pelagies
pelican	pelikaan
pelicans	pelikane
pellagra	pellagra
pemmican	pemmikaan, biltong (meer plaaslik)
pen	pen
pen name, nom de plume	pennaam
pence	pennies
penetrate	penetreer
penetration	penetrasie
penguin	pikkewyn
penguin egg	pikkewyneier
penguins	pikkewyne
penicillin	penisilien, penisiline
peninsula	skiereiland
penis	penis
penis envy	penisafguns
penitence	penitensie
penitences	penitensies
penknife	penmes
pennant	penant
pennants	penante
penniless	platsak
penny	pennie
penology	penologie
penpal	penmaat
pens	penne
pension	pensioen
pension fund	pensioenfonds
pension, retirement	pensioen
pensionable age	aftree-ouderdom
pensionable age	pensioenleeftyd
pensioner	pensioentrekker, pensionaris
pensions	pensioene
pentagon	pentagon, vyfhoek
pentagram, pentagram, vyfpuntster
pentateuch	pentateug
pentathlon	pentatlon
pentecost	pinkster, pinksterdag, pinksterfees
pentecostal theology	pinksterteologie
pepper shaker	peperpot
pepper tree	peperboom
peppermint	peperment, 
peppermint liqueur	pepermentlikeur
peptic	pepties, peptiese
per	per
perceive	persipieer
percent	persent
percent, percentage	persent
percentage	persentasie
percentage	persentasie (%)
percentage symbol	persentteken
percentages	persentasies
perception	persepsie
perceptions	persepsies
perceptual	perseptueel, perseptuele
percolate	perkoleer
percolation	perkolasie, perkolering
percolator	perkolator
percolators	perkolators
percussion	perkussie
percussion cap	perkussiedoppie
percussions	perkussies
perennial	meerjarig
perfect	perfek
perfect (v)	perfeksioneer
perfection	perfeksie
perfection	volmaaktheid
perfectionism	perfeksionisme
perfectionist (a)	perfeksionisties, perfeksionistiese
perfectionist (n)	perfeksionis
perfectionists	perfeksioniste
perforate	perforeer
perforation	perforasie
perforations	perforasies
perforator (machine)	perforeerapparaat, perforeermasjien
performance	prestasie
performance	werkverrigting
performance assessment	prestasieassessering
performer	arties
perfume	parfuum
pergola	pergola
pergolas	pergolas
perifery	periferie
perimeter	perimeter
perimeters	perimeters
perineal	perineaal, perineale
perineum	perineum
period	periode
period (US	)punt (.)
periodical, magazine, revue	tydskrift
periodically	periodiek, periodieke
periodisation	periodisering
periodise	periodiseer
periods	periodes
peripatetic	peripateties, peripatetiese
peripheral	periferies, periferiese
peripheries	periferieë
periscope	periskoop
periscopes	periskope
peristalsis	peristaltiek
perjury	meineed
permanence	permanensie
permanent	permanent, permanente
permeability	permeabiliteit
permissions	permissie
permissions	permissies
permissive	permissief, permissiewe
permissivity	permissiwiteit
permit (v)	permitteer
permit, license (n)	permit
permits, licenses (n)	permitte
permutation	permutasie
permutations	permutasies
peroxide	perokside, peroksied
perpetuate	perpetueer
perplexity	perpleksiteit
perse	presses
persecute	vervolg
persia	persië
Persian	Persies
persian	persies, persiese
Persian Gulf	Persiese Golf
persians	persiërs
personal	persoonlik, persoonlike
personal characteristics	persoonlikheidseienskappe
personal development	persoonlikheidsontwikkeling
personal growth	persoonlikheidsgroei
personal image	persoonsbeeld
personal law	personereg
personal priesthood interview	persoonlike priesterskaponderhoud
personal tax	persoonsbelasting
personal transport	personevervoer
personalities	personaliteite
personalities	persoonlikhede
personality	personaliteit
personality	persoonlikheid
personality deviation	persoonlikheidstoornisse
personality test	persoonlikheidstoets
personification	personifikasie
personifications	personifikasies
personify	personifieer
personnel administration, staff administration	personeeladministrasie
personnel development policy	personeelontwikkelingsbeleid
personnel matters	personeelaangeleenthede
personnel selection	personeelkeuring
personnel, staff	personeel
persons	persone
perspective	perspektief
perspective drawing	perspektieftekening
perspectives	perspektiewe
perspiration, sweat	perspirasie
perspire	perspireer
pertinence	pertinensie
pertinent	pertinent, pertinente
peru	peru
peruvian (a)	peruaans, peruaanse
peruvian (n)	peruaan
peruvians	peruane
perverse	pervers, perverse
perversion	perversie
perversity	perversiteit
peseta	peseta
pesetas	pesetas	
peso	peso	
pesos	peso's
pessimism	pessimisme
pessimist	pessimis
pessimistic	pessimisties, pessimistiese
pessimists	pessimiste
pest control	plaebestryding
pest, plague	pes
peste, pests, plagues
pestilence	pestilensie
pet shop	arkmark
petition (n)	petisie
petitioner	petisionaris
petitioners	petisionarisse
petitions	petisies
petrarcan	petrarcaans, petrarcaanse
petrification	petrifikasie
petrify	petrifieer, petrifiseer
petrochemical	petrochemiese
petrol engine	petrolmotor
petrol flap	petroldeurtjie
petrol flap	petrolflap
petrol flap	petrolklap
petrol pump hose	petrolpompslang
petrol, gasoline (US)	petrol
petrol-driven	petrolaangedrewe
petroleum jelly	petroleumjellie
pettion (v)	petisioneer
peyote	pejote
pharmacist	apteker
pharmacy	apteek
phase(s)	fase(s)
phase, stage	fase
phenolic	fenolies
Philippine	Filippyns
Philistine	Filistyn
phillippian	philippenser
phone line	telefoonlyn
photograph	foto
phylloxera	filloksera
physical death	fisiese dood
pianist	pianis, pianospeler
pianists	pianiste
piano	klavier
piano accompaniment	pianobegeleiding
piano bench	pianostoeltjie
piano lesson	pianoles
piano music	pianomusiek
pianos	piano's
piastre	piaster
picaresque	pikaresk, pikareske
piccolo	piccolo
pick	pluk
pick (n)	pik
picnic	piekniek hou
picnic basket	piekniekmandjie
picnics	pieknieks
pictogram	piktogram
picturesque	skilderagtig
pie, tart	tert
piece of furniture	meubel
piety	piëteit
pig	vark
pigment	pigment
pigmentation	pigmentasie
pigmentation	pigmentselle
pigments	pigmente
pigmies	pigmeë
pigmy	pigmee
pikeman	piekenier
pilgrim	bedevaarder, bedevaartganger
pilgrim	pelgrim
pilgrim to mecca	mekkaganger
pilgrim's dress	pelgrimsgewaad, pelgrimskleed
pilgrimage	bedevaart
pilgrimage	pelgrimsreis, pelgrimstog
pilgrims	pelgrims
pill-box	pildosie, pilledosie
pillar saint	pilaarheilige
pillar, column	pilaar
pillars, columns	pilare
pillion footrest	agtersaalvoetrus
pillow	bedkussing
pills	pille
pilot	piloot, loods
pilot flame	aansteekvlam
pilots	pilote, loodse	
pimple	puisie
pinch off	afknyp
pine, pine tree	masboom
pine-apple, pineapple	pynappel
pineal	pineaal, pineale
pineapple	pynappel
ping	pieng
pink	ligroos
pinkie, little finger	pinkie
Pinot noir	pinot noir
Pinotage	pinotage
pint	pint
pints	pinte
pinup girl	prikkelpop
pioneer	pionier
pioneer flights	pioniersvlugte
pioneer spirit	pioniersgees
pioneer work	pioniersarbeid
pioneer, pathfinder	baanbreker
pioneers	pioniere, pioniers
pious	piëtisties, piëtistiese
pious, religious	godsdienstig
piousness	piëtisme
pip, kernel, pit	pit
pips	pitte
Pirenean mountains	pireneëgebergtes
pisols, handguns	pistole
pistachio nut	pistasieneut
pistol, handgun	pistool
pistol, handgun	pistool, handwapen
piston	suier
pitch (n), brine	pekel
pitch black	pikgitswart, pikswart
pitch black	pikswart
pitchblende	pikblende
pituitary	pituïtêr, pituïtêre
pivot point	hefboomskarnier, hefboomsteunpunt
pivot screw	spilskroef
piëtis
plaat	sheet, record (music)
plaatkoper	sheet copper, sheet brass
plaatsing	assignment
place, location, spot	plek
placenta	plasenta
plae	pests
plage epidemic	pesepidemie
plagiarism	plagiaat
plagiarist	plagiaris, plagiator
plagiarists	plagiarisse, plagiatore, plagiators
plague bacteria	pesbakterieë, peskieme
plague bacterium	pesbakterie, peskiem
plague victim	peslyer
plague, pest	plaag
plan	beplan
plan	plan
plan of action	aksieplan
plan of attack	aanvalsplan
plan of exaltation	plan van verheerliking
plan of salvation	verlossingsplan, plan van saligheid
plan, project, scheme	projek
plane (n)	skaaf
plane (n) vlak
plane, aeroplane, airplane, air-plane	vliegtuig
planet	planeet
planetaria	planetaria, planetariums
planetarium	planeterium
planetary	planetêr, planetêre
planetary axis	aardas
planetary system	planetestelsel
planetoid	planetoïde
planets	planete
plank	plank
plank fence	plankheining
plank-like	plankagtig
planks	planke
plankton	plankton
planless, unplanned	planloos, planlose
planner	planmaker
plans	planne
plant cover(age)	plantegroeibedekking
plant distribution	plantverspreiding
plant fibre	plantvesel
plant kingdom	planteryk
plant life	plantelewe
plant nursery	plantekwekery
plant oil	plantolie
plant species, plant variety	plantsoort, plantspesie
plantations	plantasies
planted	aangeplant, verbou
planter	planter
planting	plantery
planting distance	plantafstand
planting line	plantlyn
planting season	plantseisoen
planting time	planttyd
plants	plante
plasma	plasma
plastic (a)	plasties, plastiese
plastic (n)	plastiek
plastic bag	plastieksak
plastic bucket	plastiekemmer
plastic container	plastiekhouer
plastic cup	plastiekkoppie
plastic object	plastiekvoorwerp
plastic pipe	plastiekpyp
plastic plate	plastiekbord
plasticity	plastisiteit
plateau edge	platorand
platform (railway)	perron
platform, quay, wharf	perron
platform, stage	leiding
platinum	platina
platinum blonde	platinablond
platonic	platonies, platoniese
platonists	platoniste
platypus	platipus
play	speel
playback	terugspeel (radio)
playground	baan
pleasant	aangenaam, aangename
Please?	Asseblief?
plier	tang
plot, domicile, premises, place of business 	perseel
plug (into) (v)	koppel, aanlê
plug in (v)	inprop, insok
plug-in (n)in	proptoestel, (sleng) Plug and Play-program
plumb lead	meetlood
plunger	dompelaar
plunger stick	deurdrukker
plus	plus
pocket	sak
poem	gedig
poet	digter
poetry	poësie
point	punt (.)
point of contact	aanrakingspunt
point on the agenda	agendapunt
point out to be	bleik
poisonous	giftig
Poland	Pole
polar	polêr
Pole	Pool
police	polisie
police car	polisiewa
police dog	polisiehond
police escort	polisiegeleide
police force	polisiemag
police investigation	polisieondersoek
police science	polisiekunde, polisiewetenskap
police spy	polisiespioen
police state	polisiestaat
police station	polisiekantoor
police whistle	polisiefluitjie
police-station	polisiestasie
policeman	poliesman
policies	polisse
policy, politics	beleid
poligamist	poligamis
poligamous	poligaam, poligame
poligamy	poligamie
poliginy	poliginie
polio	polio, poliomiëlitis
polish	politoer
Polish	Pools
political	politiek
political	politieke, polities, politiese
political	polities
politicians	politici, politikusse
politicise	politiseer
politicking	politiekery
politics	politiek
polka	polka
polo	polo
poltergeist	poltergees
polyester	poliëster
polyglot	poliglot
polymerisation	polimerisasie
polynesia	polinesië
polynesian (a)	polinesies, polinesiese
polynesian (n)	polinesiër
polytheism	politeïsme
polytheist	politeïs
polytheistic	politeïsties, politeïstiese
pomace mill	doppemeul
ponder	peins
ponder	pieker
ponderer	peinser
pony	ponie
ponytail	perdestert
poor	armlastig, armoedig
poor white	armblanke
POP (Post Office Protocol)	POP (Postkantoorprotokol), PKP (minder algemeen gebruik)
pop music	popmusic
pop-up	opspring
pope	pous
poplar	populier
popular	gewild
popular	populêr
population	bevolking
porch, veranda	stoep
porosity	poreusheid
porous	poreus
porousness	poreusheid
porridge	pap
port (comp)	poort
port (shipping)	hawe
Port (wine	port
port city	hawestad
portability	oordraaglikheid
porter	kruier
portfolio	portefeulje
portside	bakboord
Portuguese, Portuguese language	Portugees
position	posisie
positive plate	positiewe plaat
positive plate group	positiewe plaatgroep
possibility	moontlikheid
possible	moontlik
post	betrekking
post	pos
post (v)	pos, stuur
post-office, post office	poskantoor
postage	posgeld
postcard	briefkaart
poster	plakkaat
poster (n)	aanplakbiljet
posters	plakkate
postmaster	posmeester
pot-still brandy	potketelbrandewyn
potato chips, potato crisps (us)	aartappelskyfie
potato farm	aartappelboerdery
potato farmer	aartappelboer
potato field	aartappelland
potato harvest	aartappeloes
potato peel	aartappelskil
potato salad	aartappelslaai
potato stew	aartappelbredie
potatoes	aartappels
pottery	aardewerk
pound	pond (£)
pour, scatter, shed	giet
poverty	armoede
povertyq	armoed, armoede
powder, cosmetic powder	poeier
powdery mildew	donsskimmel
power	enjinkrag
power assisted	kraghulp (stuur)
power to attract, charisma	aantrekkingskrag
PPP (Point to Point Protocol)	PPP (Punt-na-punt-protokol)
practical	prakties
prawn	garnaal
prayer	gebed
pre-press	voor-pers
pre-school (adj.)	voorskools(e) (b.nw.)
precaution	voorsorg, voorsorgmaatreël (mv voorsorgmaatreëls)
precursor	voorloper
predecessor in office	ampsvoorganger
predetermined	voorafbepaal(de)
preexistence	voorafbestaan
preferably	liewer
preferably	sommer
prepare	voorberei
prescription, recipe	resep
presence	aanwesigheid
presence	teenwoordigheid
present	hede
present (a)	aanwesig
present (v)	aanbied
presentation	opvoering
presentation	vertoning
presenter	aanbieder
preservative	preserveermiddel
preserve	inmaak
preside	presideer, voorsit
presidency	presidensie
presidency meeting	presidensievergadering
president	president
press	pars
press	pers
press activities	persbedrywighede
press attaché	persattaché
press bureau, press office	persburo
press card	perskaartjie
press conference	perskonferensie
press flat, flatten	platdruk
press gallery	perstribune
press interviews	personderhoude
press release	persverklaring
press report	persberig
press review	persoorsig
press, oppress, squeeze	druk
press, violet	pers
pressing, urgent	dringend
pressure release valve	afblaasklep
pressure relief valve	drukontlasklep
Pretoria	Pretoria
pretreatment	voorbehandeling
pretty	aanskoulik
prevent, be found, be located, find oneself	voorkom
pride	hoogmoed
priest	priester
priestcraft	priesterlis
priesthood (authority)	priesterskap
priesthood (bearers of)	priesterorde
priesthood executive committee	priesterskap uitvoerende komitee
priesthood executive committee meeting	priesterskap uitvoerende komiteevergadering
priesthood holder	houer can die priesterskap
priesthood leader	priesterskapleier
priesthood meeting	priesterskapvergadering
priesthood office	priesteramp
primary school	laerskool
primitive	primitief
principal controls	hoofkontroles (radio)
print	druk
print-ready	persklaar
prisoner	aangehoudene
privacy	privaatheid
private	privaat
private	privaat-
private part	skaamdeel, skaamstreek
privilege	voorreg
probably	waarskynlik
problem solving	probleemoplossing
problem, trouble	probleem
problem-solving skill(s)	probleemoplosvaardigheid (...hede)
product	produk
production	produksie
production site	produksielokaal
profane (v)	ontheilig
professional	professioneel
professor	professor
profile	deursnee
program, programme	program
programme organiser	programorganiseerder
progress (n.)	progressie, vordering
promote	bevorder
promotion	bevordering
promotion	promosie
pronunciation	uitspraak
proof, sign, token	bewys
prophecy	profesie
prophecy, forecast, prognosis	voorspelling
prophesy	profeteer
proportion, rate	verhouding
proportional font	proporsionele font, proporsionele lettertipe
propstand	stutstaander
prospective elder	aspirantouderling
protest	beswaar
protest	protes
protest	protesteer
protocol	protokol
proud	trots
province	provinsie
provisional, temporary, for the time being	tydelik
proxy	volmag
prudish	preuts
prune	(n)pruimedant
prune	(v)	snoei, wegsnoei
pruning shears	snoeiskêr
prussic acid	blousuur
psychiatrist	psigiater
psychologist	sielkundige
puberty	puberteit
pubic hair	skaamhare
public	publiek
public access	algemene toegang, publieke toegang, openbare toegang
Public Domain software	Public Domain-sagteware (uitdeelware)
public prosecutor, district attorney (US)	aanklaer
publisher	uitgewer
pucker (the mouth)	plooi (mond laat trek)
pudding	poeding
puddle	plas
puddles	plasse
pulley	katrol
pulley	katrolwiel (enjin)
pulp	vleis
pulse	polsmaat, polsslag
pump attendant	petroljoggie
pump attendant	pompjoggie
pump nozzle	pompspuitstuk
pungent	skerp
punish (v)	straf
punishment	straf
punishment (n)	straf
pure yeast	reingis
purify	aansuiwer
puritan	puriteins
purple	pers
purplish	persagtige
pursuer	agtervolger
pursuit	agtervolging
push down	afdruk
put away, stow	bêre
put away, stow	wegsteek
put on	aansit
put on	aantrek
put on	omsit
put on	opsit
put on, start, switch on, turn on	aanskakel
put together, constructed	aanmekaargesit
pyramid	piramide
pyramidal	piramidaal, piramidale
pyramids	piramides
Pyrenees	Pireneë
pyrite	piriet
pyromania	piromanie
pyrotechnician	pirotegnikus
pyrotechnics	pirotegniek
quality	gehalte
quality	kwaliteitDS'e) 
quality assurance	gehalteversekering
quarantine hospital, isolation ward	afsonderingshospitaal
quarrel	argument
quarrel	rusie
quarrel, wrangle	rusie maak
quarter of an hour	kwartier
quarter window	kleinvenster
query	navraag
question	navraag
question	vraag
question mark	vraagteken 
question, dispute, quarrel	kwessie
questionable	bedenklik, bedenklike
queue (n)	tou
queue (vi)	staan in die tou, wag, vir 'n beurt wag
queue (vt)	in 'n tou laat staan, in 'n tou plaas
quiet, shy	bedees, bedeesde
quite a few	heelparty, heelwat
quite the contrary, anything but	allesbehalwe
quorum	kworum
quorum of the twelve apostles	kworum van die twaalf apostels
quotation mark	aanhalingsteken
quotations	aanhalings
quote, pet (v)	aanhaal
quoted	aangehaal
rabbi	rabbi
race, run, chase, hunt	jaag
race, run, speed	spoed
racing car	renmotor
rack and pinion	tandstag-en-kleinrat (stuur)
racking tub	tapbalie
radial ply	straallaag
radial tyre	straallaagband
radiator	verkoeler
radiator hose	verkoelerpyp
radiator hose	verkoelerslang
radiator pressure cap	verkoelerdrukprop
radio button	klinkknoppie (tbt), skakelknoppie
radium	radium
rag, scrap	flard
rain	reën
rainbow	reënboog
raisins	rosyntjies
rally	tydren
rally	veldren
rampage	amok
rancid, butyric	galsterig
range	bestek (radio)
rar	rar (kompressieformate)
rare	skaars
rat	rot
rate	tempo (bv baud)
rational (a.)	rasioneel (b.nw.)
rationale (n.)	rasionaal (s.nw.)
ratios	verhoudings
rattle off	afrafel, aframmel
ravine, cliff	afgrond
Re	Re (vir aandag, by e-pos)
re-send (n)	herpos, tweede (derde ens) pos
re-send (v)	weer stuur, weer pos
react, respond	reageer
read	lees
readiness	gereedheid
ready for action	perdfris
realm, state, condition	staat
rear end	agterent
rear entrance	agteringang
rear light	agterlig
rear seat	agterbank
rear seat	agtersitplek
rear seatbelts	agtersitplekgordels
rear suspension unit	agterveringeenheid
rear tyre	agterband
rear view	agteraansig
rear wheel	agterwiel
rear window	agterruit
rear window frame	agterruitraam
rearguard	agterhoede
rearguard action	agterhoedegeveg
rearview mirror	truspieël
rearwards	agterwaarts, agterwaartse
rebate wine	rabatwyn
rebuke	afjak
recall, recollect, remember	onthou
receiving bin	aflaaigat
recent	huidige, onlangs(e)
recent trend(s)	huidige tendens(e)
recently	onlangs
reception	onthaal
receptionist	ontvangsdame
recognise, recognize	herken
recognition (being honoured)	erkenning, 
recognition (being recognised)	herkenning
recollection	herdenking
recommend	aanbeveel
recommend against, discourage	afraai
recommend, register	aanbeveel
recommendable	aanbeveelbaar, aanbeveelbare
recommendations	aanbevelinge, aanbevelings
record changer	platewisselaar
record player	platespeler
record, register	register
record, register	registreer
recorded music	platemusiek
recording instrument	optekeningsinstrument 
recovery vehicle	takelwa (kyk ook tow truck)
rector	prinsipaal
recuperate	aansterk
red	rood
red wine	rooiwyn
redeem	verlos
redeemer	verlosser
redemption	verlossing
redress (n.)	regstelling (s.nw.) 
reduce, lessen	afneem
reduction	afname
reels	spoele
reflection (- and analysis)	nadenke (- en ontleding)
refusal	weiering
refuse, reject	weier
regarding	aangaande
regime, régime	regime
regrettably, unfortunately	jammer
regulation	voorskrif
rejection mark	afkeurmerk
rejection, refusal	bedanking
relate, tell	vertel
related	aanverwant, aanverwante
related	verwant
relation	opsig
relay race	afloswedloop, afloswedstryd
relay team (athletics)	aflosspan
release	verlos
release	vrymaak
release bar	ontkoppelstaaf
release, sack, fire	ontslaan
relevance	relevansie
reliable	betroubaar
relief society	vrouehulpvereniging
religion	godsdiens
relinquishment	afstanddoening
reliquish	afstaan
reload	herlaai
rely on, trust in	vertroue stel in
remain behind	agterbly
remain, stay, stay over, happy, glad	bly
remainder, rest	res
remaining	agterblywend
remark (n)	aanmerking
remark upon	aanmerk
remarks	aanmerkinge, aanmerkings
remediation	remediëring
remember	onthou
remission of sins	vergifnis van sondes
remote control	afstandbediening, afstandbeheer, afstandskakelaar
remotely controlled	afstandbeheerde
removal van	afhaalwa
remove	afhaal
remove a saddle	afsaal
repeat	herhaal
repellent	(n)	afskrikmiddel
repentance	bekering
replacement	plaasvervangend, plaasvervangende, plaasvervanger, plaasvervangster
reply	antwoord
report (v)	aanmeld
reporting	rapportering
repose, rest	rus
representative	verteenwoordiger
representative (adj.)	verteenwoordigend(e) (b.nw.)
reptile	reptiel
republic	republiek
repulsive	aanstootlik, aanstootlike
repulsive	afstootlik, afstootlike
repulsive, repellent (a)	afskrikwekkend, afskrikwekkende
request	aansoek
request	versoek
request (n)	aanvraag
request (v)	aanvra
request form	aansoekvorm
requirement	vereiste, verwagting
requirements	gehaltevereistes
reserve	bespreek
reserve petrol tap	agterpetrolkraantjie
residual sugar	ressuiker
resignation	bedankinge, bedankings
resinous	harpuisagtig
respect	respek
respect	respekteer
respiratory organ	asemhalingsorgaan
responsible	aanspreeklik
responsible	verantwoordelik
restitution	vergoeding
restoration	herstel
results-oriented	resultaatgeoriënteer(de)
resurrection	opstanding
retaining ring	keerring
retire	aftree
retired person, pensioner, retiree	pensioentrekker
retired person, pensioner, retiree	pensionaris
retirement	aftrede, aftreding
retreat (n)	aftog
return	terugkeer, antwoord (op 'n versoek)
return address	terugadres
return spring	terugtrekveer
return spring	truveer
return-ticket	retoerkaartjie
revcounter	toereteller
revealing	onthullende
revelation	openbaring
revelator	openbaarder
reverse, reversed, alien, contrary, opposite	teenoorgesteld
reversing light	trulig
revise	nasien
revolution counter	omwentelingmeter
revolution counter	tagometer
revolution counter	toereteller
revolver	rewolwer
revs	omwentelinge
revs	toere
revulsion	afkeer
revulsion	afsku
rewind	terugrol (radio)
RFC (Request for Comment)	RFC (Versoek vir kommentaar)
rheostat	reostaat
Rhine valley	rynvallei
rhino, rhinoceros	renoster
rice	rys
rich, wealthy, well-off	ryk
ride a horse	perdry
ride, go, travel	ry
right angle	reghoek
right at the back, most bacwards, rearmost	agterste
right-angle, square	reghoekig
right-hand side	regterkant
righteousness	geregtigheid
rim	rim (geselstrant)
rim	velling
rim flange	flens
rim flange	vellingflens
rinsing booth	afspoelkamer
rite	ritus
river	rivier
river ban	krivieroewer
road, route, way	pad
roan antelope	bastergemsbok
roast, toast	braai
rob	roof, beroof
robot	robot
robust	robuust
rock	rots
rocker cover	tuimelaardop
role-player(s)	rolspeler(s), betrokkene(s)
roll	rol, naamlys
roll	rolletjie
roll-on seal	skroefdoppie
roller bearing	rollaer
Roman Catholic Church	Rooms-Katolieke Kerk
Romania, Rumania	Roemenië
Romanian, Rumanian	Roemeen
Romanian, Rumanian	Roemeniër
Rome	Rome
roof	dak
room temperature	kamertemperatuur
root plague	wortelplaag
rootstock	onderstok
rosé wine	rosé wyn
rot off	afvrot
round brackets	hakies, ronde hakies (( ))
round off, finish (v)	afrond
roundness	rondheid
route	roete
RTFM (Read the f...ing Manual)	RTFM (Lees jou v...domde handleiding)
rub	vryf
rub rail	skuurreling
rubber wall	rubberwand
rubberstamp (v)	afstempel
rubbery	rubberagtig
rubbing strip	vryfstrook
rubbish, trash, waste (n)	afval
ruby	robyn
Ruby port	robynport
rude	astrant, astrante
rudeness	astrantheid
rule	heers
ruler	heerser
rulership	heersersmag
rules	reëls
ruling class	heersersklas
ruling family	heersersgeslag
rump, buttocks	sitvlak
run	loop, laat loop ('n program)
run	strek
run down	afhardloop
run over (a)	platgeloop, platgeloopte, platgery
run-off must	afloopmos
runway	aanloopbaan
rural	plattelands
Russia	Rusland
Russian	Rus
Russian	Russies
Russian (a)	Russies
Russian (n) Rus
rust	roes
rust off	afroes
rye	rog
sacrament	sakrament, nagmaal
sacrament meeting	nagmaaldiens
sacrament prayer	nagmaalgebed
sacrifice	offer(ww, s.nw), offerande (s.nw)
saddle	saal
safe, secure	veilig
safety, security	sekerheid
safety, security	veiligheid
sail	seil
sail off	afvaar
Saint Helena	Sint Helena
salad	slaai
salary, wage, wages	salaris
sales area	afsetgebied, afsetmark
salesman	verkoopsman
saloon	sedan
saloons	alonmotor
salt	sout
salted beef	pekelvleis
salvation	verlossing
sanction	sanksie
sand	sand
sandal	sandaal
sap	plantmelk
sardine	sardien
Sardinian	Sardinies
satan	satan
satellite	trawant
satellite control	satellietkontrole (radio)
saucer	piering
saucers	pierings
sauerkraut	suurkool, sauerkraut
sausage	wors
Sauvignon blanc grapes	sauvignon blanc-druiwe
save	verlos, red
save, spare	bespaar
save, spare	spaar
saviour	verlosser, heiland, redder
say goodbye, take leave	afskeid neem
say, tell	sê
scale	skaal
scale model	skaalmodel
scaling down	afskaling
scalpel	skalpel
scan	aftas (radio)
scandal	skandaal
scandalous	skandalig, skandalige
scandinavia	skandinawie
scanner	aftaster
scanner	aftaster (radio)
scanner	skandeerder
scarab beetle	skarabee
scarlet fever	skarlakenkoors
scene	tafereel
scene	toneel
schedule	skedule
schedule, time-table, grate, grid, grill	rooster
school holidays	skoolvakansie
science	wetenskap
scissors	skêr
scope	bereik (s.nw.) 
Scot, Scotsman	Skot
Scotland	Skotland
Scottish	Skots
scrap iron	afvalyster
scratch	krap
screen	skerm
screwtop	skroefprop
script	skrip (mv skripte), skriptaal (eenvoudige programmeertaal, algemeen), skrif scroll
script, writing	skrif
scripture	skrif
scriptures	skrifte
scroll up	na bo rol
scum	skuim
scuttle panel	luikpaneel
seal	rob
seal	seehond, rob 
sealed tank	verseëlde tenk
sealed-beam mounting ring	seëlstraalmonteerring
sealing (temple)	verseëling
sealing of an annointing	verseëling van salwing
search engine	soekmasjien, soekgids, snuffelgids, snuffelmasjien
seat belt	sitplekgordel
second	tweede
second coming of christ	tweede koms van christus
second counselor	tweede raadgewer
second death	tweede dood
second lees	fynmoer
second run-off	tweede afloop
secret	geheim
secretary	sekretaresse
secretary	sekretaris , sekretaresse
secretion	afskeiding
section	afdeling
sector	sektor
secure (n)	veilig, dig
secure (v)	beveilig
security	sekuriteit
security officer	sekuriteitsbeampte
sediment	sediment, afsaksel
sediment chamber	afsakselkamer, neerslagkamer, sedimentkamer
seduce (away from someone else)	afvry
seed	saad
seeds	pitte
seek tuning	soekinstelling (radio)
seer	siener
seldom	selde
selected yeas	tedelgis
selector	kieser (radio)
self, herself, himself, itself	self
self-assessing, self-assessment	selfassessering
self-humiliation, humbling oneself	verootmoediging
semi-colon	kommapunt (,)
semi-elliptic leaf springs	halfelliptiese bladvere (vering)
semi-sweet	halfsoet, semisoet
semi-trailer	voortreiler
send for	ontbied
send, transmit	oorsend
send, transmit	stuur
senior phase	senior fase
sense (v)	aanvoel
sense of adventure	avontuurlus
sense of hearing	gehoorsin, gehoorsintuig
sentence	sin
separate	afsonderlik, afsonderlike
separate	apart, aparte
separator	skeier
seperator	skeier
September	September
Serb	Serwies
Serb	Serwiër
Serbia	Serwië
serial port	seriepoort
serpent, snake	slang
servant	bedienaar, bediende
servants' quarters	bediendekamer
serve	bedien
serve	dien
serve	voorsit
serve, introduce, perform, present	bedien
server	bediener
service	diens
service counter	bedieningstoonbank
service provider	diensverskaffer
service station	diensstasie
service, worship service	erediens
session	sessie
settle	afsak, laat afsak
settle up	afreken
settlement	afrekening
settling agent	afsakmiddel
seven	sewe
seventeen	sewentien
seventh	sewende
seventy	sewentig
several	verskeie
several times, sometimes	somtyds
sew	naaldwerk doen
shade, shadow	skadu
shades	skakeringe, skakerings
shadow	skadu, skaduwee
shake off	afskud
shake, shock	skok
shame	skaamte
shameless	skaamteloos
share	deel, verdeel 
share	porsie
share (n)	aandeel
shareowner, shareholder	aandeelhouer
shareware	spreiware,
shark	haai
shave	skeer
shave off	afskeer
sheep farm	skaapboerdery
sheep farmer	skaapboer
sheep shearer	skaapskeerder
sheepdog	skaaphond
sheepish	skaapagtig
sheepskin	skaapvag
sheet	laken
sheets, records (music)	plate
shelf	rakkie
shepherd	herder
shepherd	skaapherder, skaapwagter
sherrif	balju
sherry	xeres
ship, vessel	skip
Shiraz	shiraz
shirt	hemp
shock absorbers	skokbrekers
shoe	skoen
shoot dead	doodskiet
short circuit	kortsluiting
short pruning	kortsnit
short term	korttermyn
short, brief	kort
shortage of labour	arbeidstekort
shortcut	kortpaadjie
shot (a)	platgeskiet, platgeskiete, platgetrek
shoulder	skouer
shouting distance	gehoorafstand
show window	winkelvenster
shy	skaam
shy bearer	skaamdraer
Siamese	Siamees
side	kant
side panel	kantpaneel, sypaneel
sideburns	bakkebaarde
sign off	uitteken
sign-up costs	aantekenkoste
signature	handtekening
signature	handtekening, naamtekening
significant	betekenisvol
significant (- skills)	betekenisvol(le) (- vaardighede)
silencer	knaldemper
silently	stilswygend
silver	silwer
simplified address	eenvoudige adres, kort adres
sin (n)	sonde
sin (v)	sondig
sin, transgress	oortree
sin, transgression	oortreding
sin, transgression	sonde
since, ever since	sedert
sing	sing
singer	sanger
single dry plate	enkeldroëplaat (koppellaar)
single mode	enkelmodus
single unit	enkel-eenheid
single, unmarried	alleenlopend, alleenlopende
single, unmarried	ongetroud
sit-down dinner	aansit-ete
site	werf
site certificate	werfsertifikaat
situation	situasie
situation comedy	situasiekomedie
six	ses
sixteen	sestien
sixth	sesde
sixty	sestig
size	grootte
skate (v)	skaats
skater	skaatser, skaatsryer
skates	skaatse
skating rink	skaatsbaan
skeleton	geraamte
ski	ski
skid ramp	slofoprit
skill(s)	vaardigheid (...hede)
skin	vel
skirt	rok
skirt	romp
skunk	muishond
slanting trellis	skuinsprieël
slash	skuinsstrepie, soms spesifiek terug-skuinsstrepie
slave	slaaf
slim	verslank
slip away, escape	ontglip
slope down	afhel, afhellende
slot	gleuf
Slovak	Slowaak
Slovak	Slowaaks
Slovak	Slowakies
Slovakia	Slowakye
Slovene, Slovenian	Sloween
Slovenian	Sloweens
slum (n)	agterbuurt
slum conditions	agterbuurtomstandighede
slum housing	agterbuurtbehuising
smal, petite	petieterig, petieterige
smell	ruik
smile	glimlag
smiley	gesiggie, laggertjie, laggerdjie (AWS-spelling)
smokey	rokerig
snail mail	slakpos, slakkepos
snout beatle	kalander, snuitkewer
snow	sneeu
snow white	sneeuwit
snow white	spierwit
so, then, therefore, certainly, indeed, rather	tog
so, then, therefore, consequently, subsequently	dus
soapy	seperig
social	sosiaal
social climber	ampjagter
Social Studies	Sosiale Studies
society	samelewing
sock	sokkie
soetheidsgraad	sweetness
sofa	sofa
soft	sag
soften up, soak	week
software	sagteware, programmatuur (meer formeel)
soil	besoedel
soil	grond
sole	tongvis
sole agent	alleenagent
sole representative	alleenverteenwoordiger
sole ruler	alleenheerser
solera	solera
solid (a)	soliede, stewig
solid particle extracts	vastestofekstrakte
solid particles, a solid	vaste stof
solitude	alleenheid
solo flight	alleenvlug
solution	oplossing
son of god	seun van god
son, boy	seun
soon	binnekort
soon	netnou
soon	nou-nou
sorry	askies
soul	siel
soul, ghost, phantom, fairy, intellect, mind	gees
sound	klank
sound	klink
sound card	klankkaart
sound wine	gesonde wyn
source	oorsprongtaal (van 'n gekompileerde program), bronskrif 
south	suide
South Africa	Suid-Afrika
South African	Suid-Afrikaans
South African	Suid-Afrikaner
South African (a)	Suid-Afrikaans
South African (n)	Suid-Afrikaner
South America	Suid-Amerika
south, southern	suidelik
spade depth	graafdiepte
spade width	graafbreedte
Spain	Spanje
spam (v)	strooi, rommel strooi
Spaniard	Spaniaard
Spanish, Spanish language	Spaans
Spanish, Spanish language	Spaanse taal
spare shoot	spaarloot
spark plug terminal	vonkpropaansluiter, vonkpropterminaal
sparkling wine	vonkelwyn
sparrow	mossie
speak in tongues	spreek in tale
speak, talk	gesels
speak, talk	praat
speakers	luidsprekers (radio)
special late harvest wine	spesiale laatoeswyn
specific	spesifiek
specifications	specifikasies
spectator	toeskouer
speed	snelheid
speed-limit, speed limit	snelheidsgrens
speedometer	spoedmeter
spell (v), take over	aflos
spell checking	speltoets
sperm	sperma
spices	speserye
spicy	pikant
spicy	pittig
spicy	speseryagtig
spike hole	koevoetgat
spiral	spiraal
spirit based	spiritusbasis
spirit of the earth	aardgees
spirit world	geestewêreld, geesteryk
spirits	spiritualieë
spirits mixer	spiritusmengeldrankie
spiritual death	geestelike dood
spit	spuug
spline	rib
split	bars
split-fold	platvou
spoil	bederf
spoiled	bedorwe
spoiler	bederwer
spoilt	bedorwe
sport	sport
sports ground	sportgrond
spread	afgee
spreadsheet	spreiblad, ontledingstaat (clc), sigblad (cmdp)
spring tension	veerspanning (radio)
spring, springtime	lente
spur pruning	kortsnit
spy upon	afloer
squab	rugleuningkussing
square brackets	blokhakies, vierkantige hakies ([])
squash	muurbal
squatter camp	plakkersdorp
squatters	plakkers
squeak	piep
squeaking noise	piepgeluid
squeaky voice	piepstem
squeeze out	pars
squirrel	eekhoring
squirrel	eekhorinkie
SSL (Secure Sockets Layer)	SSL (standvastigesok-laag)
stabiliser bar	stabiliseerstaaf
stack	bondel (versameling protokols)
staff	staf
staff member	personeellid
staff members	personeellede
staff of office	ampstaf
staff reduction, retrenchment, downsizing	personeelvermindering
staff room	personeelkamer
staff shortage	personeelgebrek
stage fright	plankekoors, plankevrees
stage(s)	stadium(s, stadia)
staircase, stairs	trap
stalk	stingel
stand-offish	afsydig, afsydige
standard works	standaardwerke
staples	krammetjies
star, celebrity	ster
start page	beginbladsy
start up (v)	laai, selflaai
start, beginning	aanvang
starter	aansitter
starter motor, start engine, electrical starter	aansitmotor
starting phase	aanvangfase, aanvangsfase
starting position, initial posture	aanvangsposisie
starting salary	aanvangsalaris
startup (n)	laaifunksie
startup capital	aanvangskapitaal
state research body	staatsnavorsingsliggaam
station	stasie
statue	standbeeld
status	aansien
status seeker	aansiensoeker
stave	duig
stay	verblyf
stay on	aanbly
stay pole	anderpaal
steak, beefsteak	kruisskyf
steal	steel
steel	staal
steelbelt	staalversterk (bande)
steering column	stuurkolom
steering damper	stuurdemper
steering lock	stuurslot
steering wheel	stuur, stuurwiel
stem	stingel
stem remover	ontstingelaar
stem, trunk, tree-trunk, tribe	stam
stemmer	ontstingelaar
stemmy	steeltjiesagtig
step	trap(pie)
step off	afstap
stereo cassette deck	stereokassetdek (radio)
stewardship	rentmeesterskap
stick to	aankleef, aanklewe
still	stil
still, yet	nog
stimulant	stimulant
sting (n)	angel
stock certificate	aandeelsertifikaat
stock exchange	aandeelmark, aandelebeurs
stockbroker	aandelemakelaar
stocking	kous
stockmarket	aandelemark
stomach	maag
stop bit	stopbis
storage	berging
storage site	bergingslokaal
story, history	geskiedenis
story, history, narrative, tale	verhaal
straight ahead, straight along	reguit aan
strain	deursyg
strained	gespanne
strained	strak
strategic	strategies
strawberry jam	aarbeikonfyt
strech, wind up	opwen
street	straat
stretcher	draagbaar
strike	staking
string (n)	string
stripper, striptease dancer	ontkleedanseres
stroller	stapper
stroller	voetslaner
stroller	wandelaar
strong	sterk
structure	struktuur
struts	stutte (vering)
sttrawberry jam	aarbeikonfyt
stubble	baardstoppel
stuck to each other	aanmekaargekleef, aanmekaargekoek, aanmekaargevleg
student, female student	damestudent
studio	ateljee
study	studeer
study	studie
stump	stomp (boom-)
sub-editor	persklaarmaker
subject field	onderwerpveld (kyk ook subject line)
subject line	onderwerplyn (kyk ook subject field)
subscription	abonnement
subsidy	subsidie
substring	substring
suburb	voorstad
succeed	slaag
success	sukses
succinic acid	barnsteensuur
succinic acid	suksiensuur
such, such a	so 'n
Sudan	Soedan
sufficient	afdoende
suffix	agtervoegsel
sugar content	suikergehalte
sugar-cane	suikerriet
suite	suite (verskillende programme saam)
sulfur	swael, swawel
sulfur dioxide	swaeldioksied, swaweldioksied
sultan	sultan
summer	somer
summons	dagvaarding
sump	oliebak
sun visor	sonskerm
sun, sunshine	son
Sunday	Sondag
sunday schools	ondagskool
sunroof	sondak
sunroof	sonvenster
supercharger	superlaaier
supermarket	supermark
supplement	aanvulling
supplement (v.)	supplementeer
supplementary budget	aanvullingsbegroting
supply	voorraad
supply (n), offer (n)	aanbod
suppress, choke, quell, suffocate	onderdruk
surf	surf, swem, skaats (blindelingse netwerktoerery)
surgeon	chirurg
surname	agternaam
surname, about, concerning	van
surplus	oorskot
surplus	surplus
surprise	verrassing
suspension	vering
suspicion	agterdog
suspicion	suspisie
suspicious	agterdogtig, agterdogtige
suspicious activities	agterdogtighede
sustain	steun
sustainable	volhoubaar (...bare)
swallow	sluk
swallow (v)	afsluk
swarm	swerm
swear	sweer
sweaty	sweterig
Swede	Sweed
Sweden	Swede
Swedish	Sweeds
sweetness	soetheidsgraad
swerve	afswenk
swimming cap	baaimus
swimming trunks, bathing costume	baaibroek, baaiklere, baaikostuum, baaipak
swimming-bath	swembad
Swiss	Switser
switch	skakelaar
switch off, turn off (a machine)	afskakel
switchboard	skakelbord
switched-on	aangeskakelde
symbol	simbool
sympathy	simpatie
symphony	simfonie
synagogue	sinagoge
synchromesh	sinchroonskakeling
sysop (system operator)	sysop (stelseloperateur)
systamatise	sistematiseer
system	sisteem
systemicq	sistemies, sistemiese
systems approach	sisteembenadering
T-shirt	T-hemp
tab	stootkeep, tabelkeep
tab menu	vakkiekieslys, oortjiekieslys
table	tafel
table fork	tafelvurk
table knife	tafelmes
table lamp	tafellamp
table mountain	tafelberg
table salt	tafelsout
table tennis	tafeltennis
table wine	tafelwyn
table-cloth	tafeldoek
tablecloth	tafellaken, tafellinne
tag	plaatjie, merker, merker, grepie
tagging language	plaatjietaal
tail	stert
tail pipe	suigpyp, uitlaatpyp
tail pipe extension	suigpypverlenging, uitlaatpypverlenging
tailless	afstert
taillight	agterlig, stertlig
taillights	agterligte
take a note of	aanteken
take away by guile or deceit	afrokkel
take off, put off	afhaal
take off, put off	uittrek
take off, put off, lie, recline	lê
take place, be set in	afspeel
take the place of, replace, substitute	vervang
taking turns	afwisselend
tangible	aantasbaar, aantasbare
tannin	tannien
tape deck	bandspeler (radio)
tape head	bandkop (radio)
tape mechanism	bandmeganisme (radio)
tape recorder	bandopneemmasjien, bandopnemer
tape slack	bandslapte (radio)
tar	tar (kompressieformate)
tar	teer
target (v.)	teiken (ww.)
targeted (adj.)	geteiken(de) (b.nw.)
tariffs	aksyns
tart, astringent	vrank
tartar	wynsteen
tartness	vrankheid
tartrate	tartraat
tartrates	tartrate
taskmaster	balju
taste	proe
taste buds	smaakkliere
tawny port	tanige port
taxi	huurmotor
taxi	taxi
taxidriver, taxi-driver	taxibestuurder
taxidriver, taxi-driver	taxidrywer
teach, leather, learn	leer
teacher (classroom)	onderwyser
teacher, female teacher	onderwyseres
teaching strategy (...gies)	onderrigstrategie(ë)
team teaching	spanonderrig
tear	traan
tear off	afskeur
tease	pla
technical	tegnies
technicians	tegnici
teetotaller	afskaffer
telegram	telegram
telegraph	telegrafeer
telephone	telefoon
telephone line	telefoonlyn
telephone, link	skakel
television, TV	televisie
television, TV	TV
tell	aansê
tell off, shake off, mildly insult	afknou
Telnet	telnet
temperance	matigheid
temperance society	afskaffingsbeweging, afskaffingsvereniging
temperature	temperatuur
temperature control	temperatuurbeheer
temperature indicator	temperatuurmeter
template	templaat, sjabloon
temple president	tempel president
tempo of fermentation	gistingstempo
temporarily	provizore
ten	tien
tendon	pees
tendons	pese
tendril	rank
tennis	tennis
tension, voltage	spanning
tent	tent
terabyte	teragreep
term	term
terminal	terminaal
terminate	termineer, beëindig (kommunikasie), termineer (netwerkkabel)
terrestrial glory	terrestriale heerlikheid
terrestrial kingdom	terrestriale koninkryk
terrestrial world	terrestriale wêreld
test	toets
test track	toetsbaan
testament	testament
testimony	getuienis
text	teks
thank	bedank
thank	dank
Thank you!	Baie dankie!
thank you, thanks	dankie
thankful	dankbaar
thanks	bedankinge, bedankings
thanks to	danksy
that	dat
that, that one	daardie een
that, that one, those	daardie
that, that over there, those	dit daardie
that, that over there, those, these, this	dit
that, which, which one, who	watter
that, which, which one, who	wie
the accused	die aangeklaagde
the almighty	die almagtige
the day before yesterday	eergister
the lord's day	die dag van die here
the other day, recently	anderdag
the other way round	andersom
the police	polisiewese
the power of suggestion	suggestie
the press	perswese
the, that, that one	die
theatre	teater
theirs	hulle s'n
them, to them, they, their, her, his, its	hulle
theme, topic, subject	onderwerp
then	dan
then	destyds
there, yonder	daar
therefore	agtereenvolgens
therefore	aldus
therefore	daarom
these, this	hierdie
these, this, this here	dit hierdie
they are	hulle is
thicken	aandik
thief	dief
third	derde
thirsty	dors
thirteen	dertien
thirty	dertig
this afternoon	vanmiddag
this evening	vanaand
those, this	dié
thou, you	jy
thought	gedagte
thoughtful	bedagsaam
thousand, one thousand	duisend
thread	rygdraad
threat	bedreiging
threaten	bedreig
threatened	bedreigde
three	drie
throat	keel
throughout	dwarsdeur
throw	gooi
throw down	afgooi
throw off	afwerp
thumb	duim
Thursday	Donderdag
tie off	afbind
tie, necktie	das
tiger	Indiese tier
tilde	tilde (~), slangetjie (minder formeel) (bvh)
timber, wood	hout
time	tyd
time down frequency range	frekwensie bestek (aftel)
time server	tydbediener
time up frequency range	frekwensie bestek (optel)
timeout	spertydperk
timer	tydreëlaar
timing chain	tydreëlketting
tinkerer	peuteraar
tip	fooitjie
tips	raad
tipsy	aangeklam
tired	moeg
tithe	tiende
tithing	tiendeheffing; die tiende
TLA (Three letter acronym)	TLA (drieletterakroniem), DLA
to be	om te wees
to each other	aan mekaar
to fellowship	inskakel
to tell the truth	eintlik
to, toward, towards	aan
to, toward, towards	na ... toe
to, toward, towards, after, close, near, nearby	na
to, toward, towards, closed, shut, now, well	toe
to, toward, towards, for, during, while, whilst	vir
toad, frog	padda
tobacco	twak
today, to-day	vandag
toddler	peuter
toddlers	peuters
together	bymekaar
together	saam
toilet	toilet
tomato	tamatie
tomorrow	môre
tomorrow evening	môreaand
tomorrow morning	môreoggend
tone	toon (radio)
tonic wine	versterkwyn
too, too much	te
tool bar	hulpstafie
tools	hulpmiddels, gereedskap
toothache	tandpyn
top level	topvlak
top, truncate	vermink
topic	onderwerp
topped	getop, ge-"top"
torque	wringkrag
tortoise	skilpad
tot	sopiemaat
touch (n)	aanraking
touch (v)	aanraak
tourism	toerisme
tourist bureau	toeristeburo
tournament	toernooi
tow truck	insleeptrok, insleepvoertuig, insleepwa, takelwa
tow-away vehicle	takelwa (kyk ook tow truck)
town council	heemraad
toxicity	toksisiteit
tracing paper	aftrekpapier
track	baan (radio)
track	spoorwydte (afmetings)
tractor unit	trekmotor (vragmotor)
trade (n)	ambag
trade school, vocational school	ambagskool
trade test, trade examination	ambagstoets, ambagtoets
trademark	handelsmerk
tradesman	ambagsman
tradesmen	ambagsliede, ambagslui, ambagsmanne
tradition	tradisie
traditional	tradisioneel
traffic block, traffic congestion, traffic jam	verkeersknoop
traffic rules	verkeersreëls
tragedy	tragedie
trailer leg	sleepwastaander, treilerstaander
trailer leg foot	treilerstaandervoet(stuk)
trailer leg winding gear	treiler(staander)opwentoestel,  hystoestel 
train	trein
trampled (a)	platgetrap, platgetrapte, platgeval
trance window (n) (Eudora)	spoorventer, spoorruitjie
tranquiliser	kalmeermiddel
transaxle helical gear	transas heliese rat
transfer (v)	oordra
transgress	oortree
transgression	oortreding
Transkei	die Transkei
Transkei	Transkei
translate	vertaal
translation	vertaling
transmit	oorsend, versend
transparant	transparant
transport	vervoer
transport log	vervoerstaaflêer
Transvaal, the Transvaal	Transvaal
trash	rommel, rommelmandjie, drommetjie
trashcan	asblik
travel, journey, trip, voyage	reis
tread	trap (v)
tread bracing layer	loopvlakver(sterking(s))laag, loopvlakspanlaag
tread design	loopvlakontwerp, loopvlakpatroon
treasurer	penningmeester, penningmeesteres
treat	onthaal
treble control	hoëtoonkontrole (radio)
tree	boom
tree fruit	boomvrugte
tree of knowledge of good and evil	boom van die kennis van goed en kwaad
tree of life	boom van die lewe
trellis wire	opleidraad
trellised vines	opleiwingerd
trellising system	opleistelsel
trend(s)	tendens(e)
tribes of israel	stamme van israel
triple-click	drie-klik, klik-klik-klik, drie-kliek
trochoid pump	trogoïedpomp
tropical	tropies
tropical fruit	tropiese vrugte
trouble	penarie
trout	forel
truck trailer	aanhaaktreiler
true, absolutely, genuinly, indeed, really, truly	werklik
trunk	koffer
trunk capacity	bagasiebakgrootte
truss	kap (n)
truss system	prieëlstelsel
truth, reality	waarheid
try on	aanpas
tub	kuip
Tuesday	Dinsdag
tulip	tulp
tumble down	aftuimel
tune (v)	instel (radio)
turbid	troebel
turbo-charged engine	aangejaagde enjin
Turk	Turk
turkey	kalkoen
Turkey	Turkye
Turkish	Turks
turn	afwyk
turn	draai
turning circle	draaisirkel
turnoff (road)	afrit
TV set, television set	televisiestel
twelve	twaalf
twenty	twintig
twenty-one	een en twintig
twenty-one	een-en-twintig
twice	tweekeer
twig	sytakkie
twin-tone hooter	tweetoontoeter
twins	tweeling
two	twee
type	blokletter
typist	tikster
tyre	band
tyre rack	band(e)rak, wielrak
ubiquitous	alomteenwoordig, alomteenwoordige
Ukraine, the Ukraine	Oekraine
Ukrainian	Oekrainer
Ukrainian	Oekrains
ullage	byvulruimte
umbrella	sambreel
umlaut	umlaut (bv ü)
unambiguous	eenduidig(e)
uncle	oom
uncouple, unfasten, loosen	afkoppel
underfermented grape sugar	ongegiste druifsuiker
underground	ondergronds
underline	onderstreep
understand, realise, realize	verstaan
understand, realise, realize, be aware of	besef
understeer	onderstuur
unemployed	werkloos
unemployment	werkloosheid
unfinished	onafgewerkte
unfortified wine	onversterkte wyn
unfortunately, unhappy	ongelukkig
unholy	onheilig
uniform	uniform
unique	uniek
unit standard(s)	eenheidstandaard(e)
United States of America, USA	VSA
unity	eenheid
university	universiteit
unless	tensy
unload	aflaai
unmask	ontmasker
unpack	uitpak
unpack, unload	afpak
unread	ongelees
untameable	ontoombaar
until	tot
until	tot by
until	totdat
unveil	onthul
unveiling ceremony	onthullingsplegtigheid
unworthy of approval	afkeurenswaardig
up front moderated	vooruit gemodereer
upgrade (n)	opgradering
upgrade (v)	opgradeer
upper deck	bodek (kyk lower deck)
upper deck	boonste dek
uppercase	bokas
uranium	uraan
URL (Uniform Resource Locator)	URL (Uniforme hulpbronopspoorder)
us, to us, we, our	ons
useful	nuttig(e), bruikbaar (...bare)
Usenet	Usenet
user	gebruiker
user ID	gebruiker-ID
user name	gebruikernaam
utilities	hulpprogramme (cmdp), byprogramme
UUCP (Unix to Unix Copy)	UUCP (Unix-na-Unix-kopiëering)
uudecode	uu-dekodeer (Unix to Unix decode)
uuencode	uu-enkodeer (Unix to Unix encode)
Vaal	Vaal
vacant	vakant
Valhalla, Walhalla	Walhalla
valid	geldig(e)
valid	geldig, korrek, aanvaarbaar,
value (v.)	waarde heg aan
value, worth	waarde
valve spring	klepveer
vanilla	vanielje
vanity mirror	grimeerspieël(tjie)
vanity mirror	smukspieël(tjie)
vapour	damp
variable (n.)	veranderlike (s.nw.)
varied (adj.)	gevarieerd(e) (b.nw.)
variety	variasie
vat	vaatjie
vat	vat (s.nw)
Vatican, the Vatican	Vatikaan
vats, large oak	stukvate
vegetable	groente
vegetable (a)	plantaardig, plantaardige
vegetables	groente
vegetation	plantegroei
vegetative	groenteagtig
vehicle	voertuig
veil	sluier
vein	aar
Venezuela	Venezuela
Venezuelan	Venezolaan
Venezuelan	Venezolaans
vent	luggang, ventluggat
vent	luik, ontluggat, syluik
vent door	ventelasiedeur(tjie), ventelasiegat
ventilation	ventilasie
verb	werkwoord
verify	verifieer
vermin	ongedierte
version	versie
very expensive	peperduur
very good	bakgat
very slippery	aalglad, aalgladde
very small	piepklein
very thin	plankdun
very young	piepjonk
via	via, oor, per
vicarious ordinances	plaasvervangende ordinansies
vicarious work	plaasvervangende werk
vice-secretary	adjunk-sekretaris
victim	slagoffer
victory	oorwinning
Vienna, Viennese	Weens
Vietnamese	Vietnamees
view	bekyk, besigting, kyk
view	uitsig
view (v)	aanskou
viewpoint	standpunt
village	dorp
vin d'ordinaire	tafeldrank
vin ordinaire	vin ordinaire, drinkwyn, tassies
vine	(wingerd)stok
vine cuttings	wingerdstokkies
vine row	wingerdry
vinegar case	asynvat
vineyards	wingerde
viniculture	wynbou
vintage	oesjaar, wynjaar, wynoes
vintage brandy	vintage-brandewyn
Vintage port	wynoesport
vintage wine	spitsjaarwyn, spitswyn
viola	altviool
viola	basviool
violin	viool
virtual	amperreële, virtuele
virtual reality	skynrealiteit (meer akkuraat), amperrealiteit, virtuele realiteit
virtuous	opreg, rein
virus	virus
visible	sigbaar
vision	visioen
visit	besoek
visitor's register	besoekersboek
visual representation(s)	visuele weergawe(s)
vitamin	vitamien
vitamin	vitamine
viticulture	wingerdbou
vocational training	ambagsonderwys, ambagsopleiding
void	kolk
volcano	vulkaan
Volga	Wolga
volunteer	vrywilliger
vote down	afstem
vulture	aasvoël
vulture	gier
vulture nest	aasvoëlnes
wages	arbeidsloon
wagon	wa
wait	afwag
waiter	kelner
waiting-room, waiting room	wagkamer
Wales	Wallis
wall	muur
Wallonia	Waleland
walnut	okkerneut
war of words	pennestryd
ward	wyk
warm	warm
warn (v)	waarsku
warning	aanmaning
warning	waarskuwing
warnings	aanmaninge, aanmanings
wash ashore	aanspoel
washing and anointing	wassing en salwing
washroom	waskamer
wasp nest	perdebynes
wasp, hornet	perdeby
wasp-waisted	perdebylyfie
waste	afloop
waste product	afskeidingsproduk
waste product	afvalproduk, afvalstof
waste removal	afvalverwydering
waste water	afloopwater
waste water, run-off water	afvloeiwater, afvoerwater
watch	horlosie
watch, wrist-watch	armhorlosie
watch, wrist-watch	polshorlosie
water	water
water cooled	waterverkoel
water pump	waterpomp
water retention	waterhouvermoë
water run	waterafloop
water-melon	waatlemoen
watermark	watermerk
watermelon	waatlemoen
watershoot	waterloot
Watt	watt
wav file	wav-lêer
wax	was
we are	ons is
weapon	afweermiddel
weapon	wapen
wear (v)	aanhê
web site	webwerf, webbladsy, webblaai, webtuiste (kyk homepage),
webmaster	webmeester
Wednesday	Woensdag
week-end	naweek
weekly	weekliks
weigh	afweeg
welcome	welkom
welded together	aaneengesweis, aaneengesweiste
well	put
well aged	goedverouderd, well matured
well-being, prosperity, success	welvaart
well-known	bekend
Welsh	Wallies
Welshman	Walliser
western	westelik
western	Westers
wet	nat
wet cardboard	nat karton
whale	walvis
what for, why	hoekom
what for, why	waarom
what kind of, what sort of	watter soort
what time	hoe laat
what, that, which, which one, who	wat
what?	wat?
wheel cylinder	wielsilinder
wheelbase	asafstand
when	wanneer
when?	wanneer?
where ... to	waar ... heen
where ... to	waarheen
where ... to	waarnatoe
where, true	waar
which one's, whose	wie se
whisky, whiskey	whisky
white (person), Caucasian	witmens, blanke
white port	witport
white wine	witwyn
who?	wie?
whole	heel
whoredom	hoererye
widely known	alombekend
widow	weduwee
widower	wewenaar
width	wydte, breedte
wife	gade
wife, woman	vrou
wild yeast cells	wilde gisselle
willingly	graag
willow	wilgerboom
wind	wind
wind break, wind breaker	windbreek, windskerm
wind deflector	windklapskerm
window	ruit
window winder handle	ruitslinger
window, show window	venster
windpipe	asempyp
windscreen	voorruit, windskerm
windscreen wiper blade	ruitveërblad, ruitveërlem
windy side	windkant
wine district	wynstreek
wine for purpose of distilling	stookwyn
winter	winter
winter prune	wintersnoei
wiper arm	ruitveërarm
wiper blade rubber	ruitveër(blad)rubber
wire	draad
wire stretcher	draadtrekker
wisdom	wysheid
wiseacre, wit	platjie
witch	heks
witchcraft	towery
with reference to	in verband met
with, by, by means of, through	met
with, together with	saam met
without	sonder
wizard	slimmerd (outomatiese hulp- opstelprogram)
wolf	wolf
womaniser	meisiesgek
womb, uterus	baarmoeder
wood	hout
wood aroma	houtaroma
wood maturation	houtveroudering
wood nose	houtaroma
wood taste	houtsmaak
wooden floor	plankvloer
woody	houtagtig
wool	wol
word	woord
word of god	woord van god
word of wisdom	woord van wysheid
word processor	woordverwerker
word wrap	woordvou, woordomvou, omvou (clc)
work therapy	arbeidsterapie
work-shy	arbeidsku
working class	arbeiderklas
working hours	arbeidsure
working-class neighbourhood	arbeidersbuurt
working-class population	arbeidersbevolking
workshop	werkswinkel
worm	wurm
worm-condenser, condensation coil	koelslange
wormwood	als-kruie, vermoets
worship	aanbid
worship (n)	aanbidding
worship (v)	aanbid
worshipper	aanbidder
worshipping	aanbiddend, aanbiddende
worthy of consideration	agtenswaardig, agtenswaardige
wrapping paper	plakpapier
wrist	pols, polsgewrig
wristwatch	polshorlosie
write	skryf
writing error, typing error	afskryffout
written	skriftelik
WWW (World Wide Web)	WWW (Wêreldwye web)
Xhosa	Xhosa
Xhosa	Xhosa-
Xhosa woman	Xhosavrou
yacht	jag
yard	yard
yardstick	meetlat, meetstok
yardstick	peilstok
year	jaar
year of vintage	oesjaar
yeast	gis (n)
yeast cells	gisselle
yeast lees	gismoer
yeasting	gisenting
yeasting	insuur
yeasty	suurdeegagtig, gistend
yell	gil
yellow	geel
yes	ja
yesterday	gister
yield	oplewer
yoghourt, yoghurt	yoghurt
you are	jy is
you, to you, thou, your	jou
you, to you, your	julle
you, to you, your	u
young	jonk
youngster, youth	jongmens
yours	joune
yours	julle s'n
yours	u s'n
yourself	uself
yugoslavia	Joego-slawië
Zambia	Zambia
zebra	sebra
zebra     sebra, kwagga
Zeus	Zeus
Zimbabwe	Zimbabwe
zinc phosphate treatment	sinkfosfaatbehandeling
zion	sion
zip	zip (kompressieformate)
zirconium	sirkonium, sirkoon
zithers, sitars	siters
zone	sone
zoo	dieretuin
Zulu, Zulu language	Zoeloe
