a little, some, to some extend	jonkin verran
a lot of, much	moni
a, any, anybody, some, somebody, someone	joku
abandon, give up, resign, renounce	alistua
abashment, embarrassment, perplexity	pula
abdomen, belly, tummy	vatsa
aberration, error, mistake	virhe
abet, agitate, incite, stir up, rouse, stimulate	kiihottaa
abide, bear, endure, put up with, suffer	kärsiä
abide, expect, wait, await, wait for	odottaa
abide, persevere, persist	pysyä
able, capable	kykenevä
able, competent, valid	pätevä
abortive, futile, useless, vain	turha
about, approximately	noin
about, round, around	ympärillä
above all, especially, chiefly, mainly	etenkin
above, on top, overhead, upstairs	ylhäällä
above, over	yläpuolella
above-board, honest	rehellinen
abrasive, lurid, sharp	terävä
abroad	ulkomailla
abrupt, steep, radical	jyrkkä
abrupt, sudden	äkillinen
absent	poissaoleva
absolute, complete, perfect	täydellinen
absolutely, definitely, without fail	ehdottomasti
absorb, sip, suck	imeä
abstract, induce, gather, infer	tehdä johtopäätös
abstract, summarize	tehdä yhteenveto
abundant	runsas
academy of music	musiikiopisto
accede, agree, consent	suostua
accent, emphasis	mahtipontisuus
accept, receive, take, take in	ottaa vastaan
acceptance	hyväksyminen
accidence, chance, hazard	sattuma
accident	tapaturma
acclaim, applaud, clap	taputtaa käsiään
acclivity, hillside, slope	rinne
accomodate, aid, assist, help	auttaa
accomodate, end, finish, terminate	lopetta
accompany	saattaa
accomplish, attain, reach	saavuttaa
according to, along	pitkin
accordion	harmonikka
account	tili
accurate, on time, prompt, punctual, exact	täsmällinen
accurate, precise	tarkka
accuse, blame	syyttää
acid	happo
acquire, attain, get, obtain	hankkia
across from, against, in exchange for, opposed to	vastaan
across, on the other side of	poikki
act, action	teko
act, be effective, have effect	vaikuttaa
act, do, make, perform, cause	tehdä
act, function, operate, run, work	toimia
actor	näyttelijä
actual, practical, real	todellinen
ad, advertisement	ilmoitus
add	lisätä
add, add up	laskea yhteen
additional, remaining, rest of, accidental	muu
address	osoite
adieu, farewell, bye, goodbye, good-bye	hyvästi
admonish, scold	kehottaa
advantageous, favourable	suopea
advantageous, useful	hyödyllinen
advertisement	mainos
advise, counsel, advice	neuvoa
affable, friendly, good-natured, kind	ystävällinen
affair, business, business deal, case, matter	asia
Africa	Afrikka
African	afrikkalainen
after	jälkeen
afternoon	iltapäivä
afterwards, next, subsequently	sitten
again, all over again, anew	jälleen
age	ikä
age, epoch, era	ajanjakso
agony, anguish, fear	tuska
agreeable, enjoyable, lovely, nice, pleasant	miellyttävä
aim, attempt, endeavour, take steps, undertake	ponnistella
aim, attempt, endeavour, try, test	koettaa
aim, goal, purpose	maali
aim, goal, purpose	päämäärä
air	ilma
airport	lentokenttä
ale, beer	olut
alien, foreign, strange, guest	vieras
all about, everywhere	kaikkialla
all, each, every, everyone	jokainen
allow, leave, let, release	jättää
allow, permit	sallia
allude, hint, indicate, suggest	viitata
almost, nearly	melkein
alone, only, sole, solitary	yksin
already, by now, yet	jo
also, too	myös
altitude, height	korkeus
altogether, everything	kaikki
always	aina
America, United States of America, USA	Amerikka
American, US citizen	amerikkalainen
among, between	kesken
amount, sum	summa
amuse	huvittaa
anchor	ankkuri
and	ja
angel	enkeli
animal, beast	eläin
anoint, smear, spread	voidella
answer, reply, respond	vastata
anything, something	jokin
anywhere, somewhere	jossakin
apart from, besides, except	paitsi
apart, particular, separate, special	eri
ape, monkey	apina
appall, dismay, puzzle	ällistyttää
apparatus, device, set, means, tool	koje
appear, emerge, perform	tulla näkyviin
appellation, name	nimi
appetite	ruokahalu
apple	omena
appraise, estimate, rate	arvioida
appreciate, like	arvostaa
approve	hyväksyä
April	huhtikuu
Arab	arabi
Arabian, Arabic	arabialainen
arbitrary	mielivaltainen
arc, bow	kaari
arise, be born	syntyä
arm	käsivarsi
arouse, wake, awaken, wake up	herättää
arrange, fix up	järjestää
art	taide
article, object, thing	esine
as if, as though, in a way	ikäänkuin
as, how, like, such as	miten
ascertain, establish, take note	todeta
ash, cinder	tuhka
Asian	aasialainen
ask	kysyä
ask, ask for, beg, bid, request	pyytää
asparagus	parsa
aspen	haapa
aspire, aspire to, hope for, strive for	pyrkiä
ass, donkey	aasi
assault, attack	hyökätä
assemblage, gathering, meeting	kokous
assemble, link, mount	asentaa
assent, say yes	myöntää
at all, entirely, wholly	aivan
at all, ever	tahansa
at least	ainakin
at once, right away, right now	heti
at present, now	nyt
at some time, ever	jolloinkin
at the rate of	kohti
at, beside, by, near to, next to	vieressä
at, beside, with	luona
Atlantic, Atlantic Ocean	Atlantti
atmosphere, ethos, mood	ilmapiiri
attach, determine, fasten, fix, affix, make fast	kiinnittää
attend, call on, see, visit	käydä vieraissa
attend, nurse, tend to, look after	hoitaa
attentive	tarkkaavainen
attest, bear witness of, testify	todistaa
attitudinize, pose, put on airs	olla olevinaan
attract, decoy, lure	houkutella
auditor, government inspector	tarkastaja
August	elokuu
aurora, dawn	aamurusko
Australia	Australia
Australian	australialainen
authority	arvovalta
autumn	syksy
avaricious, miserly, stingy	saita
avenge, avenge oneself	kostaa
average	keskiarvo
average, middle	keskipiste
avid, eager for, greedy	ahne
avoid, evade	välttää
away	pois
baby	vauva
back	selkä
back of the neck, nape	niska
background	tausta
bacon	ihra
badger	mäyrä
bag, sack	säkki
bake	leipoa
ball, ball-bearing, globe	pallo
ball, dance	tanssiaiset
bank, border, edge, shore	ranta
bare, naked, nude	alaston
barely, hardly, only just, scarcely	tuskin
bark	haukkua
barrel, channel, pipe, tube	putki
base, basis, bench, easel, tressle, workbench	alusta
basement, cellar	kellari
basin, bowl, pelvis, course, dish, platter	vati
bass	ahven
bathe	kylvettää
baton, cane, stick	keppi
be	olla
be acquainted with, know, feel, sense	tuntea
be afraid of, fear	pelätä
be alive	elää
be angry	suuttua
be asleep	nukkua
be aware of, be conscious of, realise, realize	tajuta
be bored, be tired of something	ikävöidä
be called	olla nimeltään
be delirious	hourailla
be indignant	närkästyä
be lacking, be missing	puuttua
be lenient with, indulge, spare	armahtaa
be on duty, serve	päivystää
be quiet	vaieta
be right	olla oikeassa
be situated	sijaita
be sorry about, regret	valittaa
be vacant	olla avoinna
be willing to, want, wish	tahtoa
be worthy of, deserve, merit	ansaita
beak, bill	nokka
beam, girder	hirsi
beam, ray	säde
bear, produce	tuottaa
beard	parta
beat, hit, strike	lyödä
beautiful, fine, handsome, lovely	kaunis
because of, for sake of, on account of	vuoksi
because, for, since	koska
become, get, grow	tulla joksikin
bed	vuode
bee	mehiläinen
befit, be fitting, be appropriate, suit	sopia
before, in front of	edessä
beget, generate	siittää
begin, commence, start	aloittaa
beginning, commencement, start	alku
behave, conduct oneself	käyttäytyä
behold, here is, here are, look	tässä
believe, deem	uskoa
bellow, bleat, neigh	ammua
below, beneath, under	alla
belt, girdle	vyö
bench	pulpetti
bend, incline, tilt	kallistaa
bent, curved	käyrä
bet, wager	lyödä vetoa
betray, cheat, deceive	pettää
bewitch	taikoa
beyond, past, straight past	ohi
big, great, large	iso
bike, cycle, bicycle	polkupyörä
bill, ticket, note, banner, flag	lippu
bind, connect, join, tie, tie up	sitoa
binding, strip, tape	nauha
binoculars	kiikari
birch	koivu
bird	lintu
bite	purra
black	musta
blade	terä
blame, rebuke, reproach, reprove, scold	moittia
blank, white	valkea
blaspheme, cuss, curse, swear	herjata
blend, mingle, mix, shuffle	sekoittaa
bless	siunata
blind	sokea
blond, fair, bright, clear, light	vaalea
blood	veri
bloom, flower	kukka
blot, spot	tahra
blouse	pusero
blow	puhaltaa
blue	sininen
board, plank	taulu
boat	soutuvene
body	keho
boil	kiehua
bold, corpulent, fat, thick	paksu
bolt, fasten, lock	lukita
bone	luu
book	kirja
boot	saapas
bore	ikävystyyää
bore, drill	porata
borrow, lend, loan	lainata
bosom, breast, chest	rinta
boss, chief, leader	päällikkö
boss, master	isäntä
botch, bungle, screw up, spoil	hutiloida
both	molemmat
bother, disturb, hinder, trouble	vaivata
bottle	pullo
bottom, foundation, ground	pohja
bough, branch	oksa
boundary, frontier, limit	raja
boutique, shop, store	myymälä
bovine, bovine animal	härkä
box	rasia
brain	aivot
brake	jarru
branch, compartment, department, pigeonhole	lokero
brandish, fling, swing, wave, wave about	heiluttaa
brandy, cognac	konjakki
brave, courageous, valiant	rohkea
brave, gallant	uljas
Brazil	Brasilia
Brazilian	brasilialainen
bread, loaf	leipä
break	särkeä
break, intermission, pause, recess	tauko
bream	lahna
breast, teat	nisä
breathe	hengittää
breed, bring up, educate, raise	kasvattaa
breed, race	rotu
bridge	silta
bright, brilliant	loistava
Britain, Great Britain	Iso-Brittania
British	brittiläinen
broad	leveä
brother	veli
brown	ruskea
brush	harja
bucket, pail	ämpäri
buffet	tarjoiluhuone
bug, insect	hyönteinen
build, build from wood	veistää
build, construct	rakentaa
bulk, dimension, extend, size	laajuus
bullet	kuula
bump, hump	kyttyrä
burden, charge, load	lasti
burn	palaa
burst	haljeta
business, trade	kauppa
but	mutta
but, however, nevertheless, yet	kuitenkin
butcher, slaughter	teurastaa
butter, woe	voi
butterfly	perhonen
button	nappi
buy, purchase	ostaa
buzz, hum	surista
by no means, in no way, not at all	ei kuinkaan
cabbage	kaali
cabin	hytti
cabin, hut, shack	mökki
cabinet, closet, cupboard, sideboard	kaappi
cadaver, corpse	ruumis
cadre, frame, framework	kehys
cake	kakku
calculate, count, figure, work out	laskea
calendar	kalenteri
calm, quiet, serene, untroubled, tranquil	tyyni
Canada	Kanada
Canadian	kanadalainen
canal, channel	kanava
candle	kynttilä
caprice, whim	oikku
captain	kapteeni
capture, catch, grapple	pyydystää
car, automobile, motor car, motor-car	auto
card, map, menu	kortti
care for, cure, treat	parantaa
care, see, take care, worry	huolehtia
caress, chuck, fondle, stroke	hyväillä
carp	karppi
carriage, coach, railway carriage, waggon	vaunu
carrot	porkkana
carry, wear	kantaa
cart, chariot	kärryt
cartridge	haulipanos
cash, in cash	käteinen
cashier's stand, fund, money box, money-box, till	kassa
castle, tower	torni
cat	kissa
catalog, catalogue, directory	luettelo
Catholic	katolinen
cauliflower	kukkakaali
cause, reason	syy
caution, warn	varoittaa
cave, cavity	kolo
cease, stop	lakata
cede, give in, give up, give way, relinquish	väistyä
ceiling	laipio
celebrate	juhlia
celebration, festival, party	juhla
cell	solu
cello	sello
cent	sentti
center, centre	keskus
ceremonious, solemn	juhlallinen
certain, sure, safe, secure	varma
certainly, indeed, rather, surely	han
chain	ketju
chair	tuoli
chairman, president	puhemies
chalk	liitu
chance, luck	mahdollisuus
change, turn	muuttaa
chap, guy, fellow, person	olio
charlatan, imposter, quack	puoskari
charming, lovely	suloinen
chase, drive, drive on, impel, shoo	karkottaa
chase, hunt	metsästää
chat, chatter	lörpötellä
cheat, crook, rogue	roisto
cheek	poski
cheerful, gay, merry	iloinen
cheese	juusto
cherry	kirsikka
chicken, fowl	kukko
child, infant	lapsi
child, offspring, young	jälkeläinen
chilli	chilipippuri
China	Kiina
Chinese	kiinalainen
chocolate	suklaa
choke, quell, suffocate, suppress	tukehduttaa
choose, elect, pick out	valita
chop, cut, hack	hakata
Christ	Kristus
Christian	kristitty
Christmas, Yule	joulu
chunk, clod, lump	kimpale
church, kirk	kirkko
cider	siideri
cigarette	savuke
cipher, digit, figure, numeral, number	numero
circle	ympyrä
circumstances, condition, situation	tilanne
circus	sirkus
cite, quote	siteerata
city, town	kaupunki
class, course	kurssi
clay	savi
clean, pure	puhdas
cleanly cut, net, neat, precize	netto
clear, distinct, plain	selvä
clef	nuottiavain
clever, cunning, sly, smart	viekas
clever, dexterous, skillful	taitava
client, customer	asiakas
climate	ilmasto
clip, cut, shear, slice	leikata
cloak, mantle	takki
clock, watch	kello
close, near, nearby, next	läheinen
close, shut	sulkea
cloth	liina
cloth, material	kangas
cloud	pilvi
club, society	kerho
coal	hiili
coffee	kahvi
collect, gather, pick up	kerätä
collide	törmätä
column, pillar	pylväs
comb	kammata
come	tulla
come about, happen, occur	tapahtua
come across, encounter, meet, see	tavata
comfort, console	lohduttaa
command, order, tell	käskeä
commend, laud, praise	ylistää
commodity, merchandise, wares	tavara
common, joint	yhteinen
common, ordinary, usual	tavallinen
community	kunta
compare	verrata
compartment, coupé	vaunuosasto
compass	kompassi
compatible, congruent	yhteneväinen
compete, rival	kilpailla
complaint	valitus
complete, full	täysi
complicate	mutkistaa
compose	säveltää
compose, create, write	laatia
conceal, hide	piilottaa
concentrated, dense, thick	tiheä
concern, relate	suhtautua
concert	konsertti
condition, state	tila
condition, stipulation, terms	ehto
condom, rubber	kondomi
conduct, direct, guide, head, lead	opastaa
confirm, corroborate	vahvistaa
conflict	ristiriita
confuse, puzzle	hämmentää
congratulate	onnitella
conjecture, surmise	otaksua
connect, connect up, plug in, switch, turn on	kytkeä
connection, league	liitto
conscience	omatunto
conserve, keep, maintain, preserve	säilyttää
consider, deem, look, look at, regard, view	katsella
consider, esteem, regard	harkita
consist of	koostua
constant, continual, permanent, sustained	pysyvä
consume, use up	kuluttaa
contact	kosketus
contented, pleased, satisfied	tyytyväinen
continent, mainland	maanosa
continue, endure, keep on, last	kestää
continue, go on, proceed with	jatkaa
contribute	maksaa osansa
control, govern, restrain, rule	hallita
convince, persuade	vakuuttaa
cook	keittää
copper	kupari
copy	jäljentää
copy	yksilö
cord, rope, string	köysi
cord, string	jänne
core, nucleus, kernel, pit	ydin
cork	korkki
corn, Indian corn, maize, mealies	maissi
corner	kulma
correct, exact, proper, right	oikea
correct, harvest	korjata
correspond	vaihtaa kirjeitä
cost, pay	maksaa
costume, outfit, suit, dress, gown, robe	puku
cotton	puuvilla
count	luetella
country, land, ground, grounds, terrain, earth	maa
coupon	kuponki
court, yard, courtyard	piha
courteous, polite, well-mannered	kohtelias
cover	peittää
crane	kurki
crazy, insane, mad, nuts	hullu
creak, grate	narista
create	luoda
cross	risti
crowd, heap, mass, multitude, pile	kasa
crude, raw, rough	raaka
cruel	julma
cruise	risteillä
crush, pound	survoa
crush, shatter, smash	murskata
cry out, scream, shout	huutaa
cry, weep	itkeä
cuckoo	käki
cultivate, grow	viljellä
cultured, educated, learned, well-informed	sivistynyt
cup	kuppi
curious, interesting, quaint, odd, peculiar	kummallinen
curtain	verho
custom, habit, way, manner, mode, mores	tapa
cycle	jakso
czar	tsaari
damage, injure, spoil	pilata
damn	tuomita kadotukseen
danger, peril	vaara
Danish, Dane	tanskalainen
Danube	Tonava
date	päivämäärä
day	päivä
deaf	kuuro
deal with, handle, treat	neuvotella
dear, expensive, lovely, valuable	kallis
decayed, decrepit, dilapidated, lapsed, rickety	raihnas
December	joulukuu
decide	päättää
deck	laivan kansi
deem, opine, think	arvella
deep, profound	syvä
defecate	ulostaa
define, determine	määritellä
degree, grade	aste
delight	hurmata
delight in, enjoy	nauttia
demand, postulate, require	vaatia
den, nest	pesä
Denmark	Tanska
denounce	antaa ilmi
deposit	tallettaa
desert	autiomaa
deserving, worthy	arvoinen
design, draw	piirtää
desire, wish	haluta
despite, in spite of, notwithstanding	huolimatta
detailed	seikkaperäinen
develop, evolve	kehittyä
dial, disc, disk, record	kiekko
die, expire, pass away	kuolla
differ, be different	erota
difference	erotus
dig, grub, spade	kaivaa
dike, embankment	pato
diligent, hardworking, industrious	ahkera
dimension, measurement	ulottuvuus
direct, guide, manage, steer	suunnata
direct, straight	suora
discipline	kuri
discrete	tahdikas
discuss	pohtia
dismal, dreary, sad	surullinen
dispose of, sell, vend	myydä
dissemble	teeskennellä
distance, offset	etäisyys
distinguish	erottaa
distract, divert, entertain	häiritä
distribution	vanavesi
diverse, varied, various	erilainen
divide, separate, share	jakaa
doctor, physician	lääkäri
dog	koira
door, gate	ovi
dot, period, point, spot	piste
doubt, suspect	epäillä
dove, pigeon	kyyhkynen
down, fluff	untuva
drag, draw, haul, pull, tug	vetää
drag, tow	laahata
dragonfly	sudenkorento
draw	ammentaa
drawers, panties, underpants	alushousut
dream	uni
dream, daydream, fancy	uneksia
drink	juoda
droop, hang	riippua
drop, fall	pudota
drown	hukkua
drug, medicine, pharmaceutical	lääke
drum	rumpu
drunk, intoxicated	juopunut
dry	kuiva
duck	sorsa
dues, subscription	jäsenmaksu
dull, obtuse	tylppä
dumb, mute, speechless	mykkä
dung, excrement	lanta
dusk, twilight	hämärä
dust	pöly
Dutch, Dutchman, Hollander	hollantilainen
duty, obligation	velvollisuus
dwell, live	asua
eagle	kotka
ear	korva
early	aikainen
early	aikaisin
earn, gain, win, defeat, win over	voittaa
earnest, serious	vakava
east, East	itä
Easter	pääsiäinen
easy, facile	helppo
eat, feed	syödä
edge, rim, brim	reuna
edit	toimittaa
edition	painos
eel	ankerias
effect, impression	teho
egg	muna
Egypt	Egypti
Egyptian	egyptiläinen
eight	kahdeksan
eighteen	kahdeksantoista
eighth	kahdeksas
eighty	kahdeksankymmentä
electricity	sähkö
element	alkuaine
element, fragment, item, particle	osanen
elephant	norsu
eleven	yksitoista
elk, moose, deer	hirvi
emblem	tunnus
eminent	etevä
employ, hire	palkata
employ, use, make use of	käyttää
empty, void	tyhjä
encourage, impel, instigate, spur on, stimulate	yllyttää
end, ending	loppu
engine	veturi
engine, machine	kone
engine, motor	moottori
England	Englanti
English, Englishman, Sassenach	englantilainen
enigma, puzzle, riddle	arvoitus
enough, rather, sufficiently	kylliksi
enthusiasm, verve, vivacity	innostus
entire, overall, whole	koko
entrust, tell	antaa tehtäväksi
envelope	kirjekuori
envy	kadehtia
equal, even, level, similar	yhtäläinen
equator	päiväntasaaja
equilibrium	tasapaino
erect, establish, found	perustaa
erotic	aistillinen
err, make a mistake	erehtyä
errand, message	sanoma
escape, flee	päästä karkuun
essence, gist	olemus
estate, farm, property, ranch	maatila
esteem, think well of, commend, glorify, laud	kunnioittaa
Europe	Eurooppa
European	euroopalainen
European	eurooppalainen
even	vieläpä
even, flat, level, smooth	tasainen
evening	ilta
every kind of	kaikenlainen
everyone's	jokaisen
evident, obvious	ilmeinen
examine, explore, investigate, research	tutkia
example	esimerkki
excite, abet, incite, provoke, rouse, stimulate	ärsyttää
exclusively, just, only	vain
exercise-book, folder, notebook	vihko
exhibition, exposition	näyttely
exist	olla olemassa
experienced, expert	kokenut
explode	räjähtää
export	viedä maasta
express	ilmaista
expression	ilme
extend, strech out	ojentaa
extensive, spacious, vast, wide	avara
exterminate, wipe out	hävittää
extinguish, put out	sammuttaa
extreme	äärimmäinen
eye	silmä
face	kasvot
fact	tosiasia
factory, mill	tehdas
faint, swoon	pyörtyä
fair, just, righteous	oikeudenmukainen
fair, market, sales activity	markkinat
fairy	haltia
faithful, loyal	uskollinen
falsify	väärentää
fame, renown	maine
family	perhe
fantasy	mielikuvitus
fare, be able to, can, may	voida
farm	vuokrasopimus
farm, lease	vuokrata maata
fashion, mode	muoti
fast, firm, stable	luja
fast, quick, rapid, speedy, swift	nopea
fat, grease	rasva
fateful, ill-fated	kohtalokas
father	isä
faucet, tap	hana
feather, pen	kynä
feature, trait	piirre
February	helmikuu
feed, nourish	ravita
fellow, man	mies
ferry	proomu
fervor, fervour, zeal	into
fever	kuume
fiancé	sulhanen
fiber, fibre	säie
fiction	kuvitelma
field	pelto
fifteen	viisitoista
fifth	viides
fifty	viisikymmentä
file	viilata
file, line, rank, row, turn	rivi
filter	suodattaa
find	löytää
finger	sormi
finished, ready, through	valmis
Finland	Suomi
Finnish	suomalainen
fire	tuli
fish	kala
fit, suit, be suitable	kelvata
five	viisi
flame	liekki
flat	laakea
flatter	imarrella
flee, run away	paeta
fleet	laivasto
flesh, meat	liha
flirt, flit, flutter	hakkailla
float, swim	uida
floor	lattia
floor, storey, story, layer	kerros
flounder, struggle, writhe	rimpuilla
flour, meal	jauhot
flow	virrata
fluid, liquid	aalto
flute	huilu
fly	lentää
fly, housefly	kärpänen
foam, froth	vaahto
fog, mist	sumu
fold, bend	taivuttaa
folk, nation, people	kansa
follow	seurata
foolish, stupid	tyhmä
foot, paw	jalka
for every reason	mistä tahansa syystä
for no reason	turhanpäiten
for some reason	jostakin syystä
for, during, while, whilst	aikana
for, to, in order to	varten
force, impose	tyrkyttää
forge	takoa
forget	unohtaa
forgive, pardon	antaa anteeksi
fork	haarukka
form, shape	muoto
fortunate, happy	onnellinen
fortune	onnetar
forty	neljäkymmentä
fountain, source, spring, well	kaivo
four	neljä
fourteen	neljätoista
fourth	neljännestunti
fourth	neljäs
free	vapaa
freeze	pakastaa
French, Frenchman	ranskalainen
frequently, often, regularly	usein
fresh, recent	tuore
Friday	perjantai
friend	ystävä
frog	sammakko
from, out of	ulos
from, since	lähtien
fruit	hedelmä
frying-pan, frying pan	pannu
fuel	polttoaine
full, replete, satisfied	kylläinen
fun, pleasure	huvi
function, job, office, post	virka
fund	rahasto
fungus, mushroom, sponge	sieni
fur, fur coat, fur piece	turkis
fur, hide, skin	talja
furious	raivoisa
furnace, kiln, oven, stove	uuni
further, more	edelleen
future	tuleva
gallery	parveke
gamut, key, scale	sävelasteikko
gape, gawk	töllistellä
garden	puutarha
gas	kaasu
gazette, magazine, newspaper, periodical	sanomalehti
general, usual	yleinen
generation	sukupolvi
genius	nerous
gentle, mild	lempeä
gentle, soft, sweet, tender	makea
geography	maantiede
germ	itu
German	saksalainen
Germany	Saksa
gesture	ele
get along, proceed, progress	edistyä
get, have, receive	saada
get, lay hold of, pick up, take	ottaa
gift, present	lahja
give	antaa
give birth, labour, be in labour, bear	synnyttää
gladness, joy	ilo
glass	juomalasi
glass	lasi
glide, slip	liukua
glove, mitten	hansikas
glow, glow with heat	hehkua
glue	liima
glue, stick	liimata
go	mennä
go for a walk, stroll	olla kävelyllä
go, ride, travel	ajaa
goblet, toast	malja
goblin, imp	tonttu
God	Jumala
gold	kulta
golf, gulf	lahti
good, nice, okay	hyvä
goose	hanhi
graceful	siro
grade, note	muistiinpano
grain	vilja
grain, granule, pip	jyvä
grandfather	isoisä
grape	rypäle
grass	ruoho
grate, rasp	kaapia
grave, tomb	hauta
gravel, grit	sora
gravy, sauce	kastike
gray, grey	harmaa
Greece	Kreikka
Greek	kreikkalainen
green	vihreä
greet, salute	tervehtiä
greeting	tervehdys
grind, pulverize	jauhaa
groan, moan	huokailla
group	ryhmä
grow, vegetate	kasvaa
growl, grumble	nurista
grub, larva, caterpillar	toukka
gruel, mess, mush	puuro
guarantee, warrant	taata
guard, keep, look after, watch over	vartioida
guess	aavistaa
guess, presume, suppose, surmise	olettaa
guilty	syyllinen
guitar	kitara
hail	raesade
hair	hius
half	puolikas
halt, come to a halt, stop	pysähtyä
ham	kinkku
hand	käsi
hang onto, hold	pitää
harbor, harbour, port	satama
hare	jänis
harmonica	sointuoppi
hat	hattu
have compassion on, pity	sääliä
have faith, have faith in, trust, confide	luottaa
have to, must, ought to, should	täytyä
have, have got, own, possess	omistaa
hay	heinät
hazard, risk, venture	vaarantaa
he, him, her, she	hän
head of cattle	nauta
head, pate	pää
healthy, well	terve
hear	kuulla
heart	sydän
heat, stoke	lämmittää
heaven, sky	taivas
Hebrew, Jewish	juutalainen
hedge	pensasaita
helix, propeller	potkuri
helmet	kypärä
hero	sankari
herring	silli
high, lofty, tall	korkea
highway	valtakatu
hip	lonkka
hire	vuokrata
hit, knock, strike	iskeä
holder, socket	pidin
hole	reikä
Holland, the Netherlands	Alankomaat
home	koti
honey	hunaja
hook	haka
hope	toivoa
horizon	horisontti
horse	hevonen
horse-radish, horseradish	piparjuuri
hotel	hotelli
hour, o'clock, time	tunti
house	talo
how many, how much	paljonko
how many, what number	monesko
humane	inhimillinen
humble	nöyrä
hundred, one hundred	sata
Hungarian	unkarilainen
Hungary	Unkari
husband	puoliso
hyaena, hyena	hyeena
I, me	minä
ice	jää
Iceland	Islanti
idea	aate
if, provided that	jos
ignore	olla välittämättä
illustrate	kuvittaa
image, picture	kuva
imitate	jäljitellä
imply, mean, signify	merkitä
important, serious	tärkeä
impression	vaikutus
in every way	kaikin tavoin
in turn	vuoron perään
inclined	taipuvainen
income, return	korko
index, table, tablet, tabulation	taulukko
India	Intia
Indian	intialainen
indicate, point out, show, appear, appear to be	näyttää
inherit	periä
initiate, start	tehdä aloite
ink	muste
inner, internal	sisäinen
inquiry, investigation	kysely
insist	vaatimalla vaatia
inspect, audit, check, check up on, supervise	tarkastaa
inspiration	luomisvire
instant, moment	hetki
instead of	sijaan
instinct	vaisto
intelligent, sagacious, prudent, reasonable	älykäs
interchange, swap	vaihtaa
interest	kiinnostaa
interpret	tulkita
intestine	suoli
intrigue	juonitella
introduce, perform, present	esittää
invite, call, summon	kutsua
Ireland	Irlanti
Irish, Irishman	irlantilainen
iron	rauta
island	saari
Israel	Israel
Israelian	israelilainen
Italian	italialainen
Italy	Italia
January	tammikuu
Japan	Japani
Japanese	japanilainen
jeer at, make fun of, mock	pilkata
jest, joke	laskea leikkiä
jewel	jalokivi
join, associate, come together, pool	liittyä
journey, trip, voyage	matka
judge	tuomita
jug, box, container, vessel	säiliö
jug, pot	ruukku
juice, sap	mehu
July	heinäkuu
jump, leap, spring	hypätä
June	kesäkuu
just, just now	juuri
keel	köli
keep an eye on, spy on	tähystää
keep, save, rescue	pelastaa
kilo	kilogramma
kind, sort	laji
king	kuningas
kiss	suudella
knee	polvi
knot, node	solmu
know, know how	tietää
lacquer	lakka
lagoon	laguuni
lake, loch	järvi
lament, wail	valitella
lamp	lamppu
landscape, scenery	maisema
last	viimeinen
lath, slat	riuku
laugh	nauraa
launch	laskea vesille
law	laki
lay down, place, put, put down	panna
lay out, spread, spread out	levittää
lead	lyijy
leaf, sheet	lehti
lean, support, sustain	nojata
learn	oppia
leather	nahka
lecture	luento
leg, paw	sääri
lemon	sitruuna
lemonade	limonaadi
lens	linssi
letter	kirjain
letter	kirje
letterbox, mailbox	postilaatikko
lettuce	lehtisalaatti
level	taso
lever, lift, raise	nostaa
liberal	vapaamielinen
lie, recline	maata
lie, tell a lie	valehdella
light	valo
lightning	salama
like this, so, that way, thus	siten
line	viiva
lion	leijona
lip	huuli
list	lista
listen	kuunnella
liter, litre	litra
lively, witty	henkevä
liver	maksa
lobster	hummeri
location, place, spot, position	paikka
lock	lukko
long	pitkä
long for, yearn	kaivata
look for, seek	etsiä
lorry, truck	kuorma-auto
lose	kadottaa
loud	äänekäs
love	rakastaa
lull, rock	tuutia
lump, mass	massa
lump, piece, spare part	pala
lunch, snack	lounas
lung	keuhko
lust, passion	intohimo
lute	luuttu
lyric, text	teksti
maestro, master	mestari
mail, post	posti
make a noise	meluta
malicious, mischievous, nasty, vicious	ilkeä
man, human being	ihminen
map	kartta
March	maaliskuu
march, walk	marssia
mark, character, sign, signal, token	merkki
mark, stamp	leimata
marsh, swamp	suo
marvel, marvel at, wonder	ihmetellä
mask	naamari
mat	matto
match	tulitikku
May	toukokuu
meaning, sense	merkitys
means, remedy, resources	keino
measure	mitata
meditate, think to oneself	miettiä
melody, tune	sävelmä
melon	meloni
melt	sulattaa
member, supporter, limb	jäsen
menace, threaten	uhata
mention	mainita
menu	ruokalista
meter, metre	metri
method	menetelmä
Mexican	meksikolainen
Mexico	Meksiko
middleclass citizen	porvari
migrate, roam, wander, wander about	vaeltaa
mile	peninkulma
milk	lypsää
milk	maito
millimeter, millimetre	millimetri
million	miljoona
mind	mieli
minute	minuutti
mirror	peili
misery	kurjuus
model	malli
model, pattern, scheme	kaava
modest	vaatimaton
Monday	maanantai
money	raha
month	kuukausi
moon	kuu
morals	siveellisyys
more	enemmän
morning	aamu
most	eniten
motive, reason	vaikutin
mountain	vuori
mouse	hiiri
mouth	suu
move, stir	liikuttaa
mud	loka
mud, slime	lima
murder	murhata
murmur, mutter	kohista
muscle	lihas
muse	runotar
museum	museo
music	musiikki
musical instrument	soitin
musical time, tact	tahti
mustard	sinappi
mutton	lammas
mutual, reciprocal	vastavuoroinen
naif, naïf, naive, naïve	lapsellinen
nail	kynsi
nail	naula
nasty	inhottava
nation	kansakunta
nationality	kansallisuus
necessary	välttämätön
neck	kaula
need, require	tarvita
Negro	neekeri
neighbor, neighbour	naapuri
neither	eikä
net, network	verkko
never	ei koskaan
new, novel	uusi
night	yö
nine	yhdeksän
nineteen	yhdeksäntoista
ninety	yhdeksänkymmentä
ninth	yhdeksäs
no, not	ei
no-one's	ei kenenkään
noble	jalo
nobody, no-one	ei kukaan
none	ei lainkaan
norm, standard	sääntö
normal	säännönmukainen
north, North	pohjoinen
Norway	Norja
Norwegian	norjalainen
nose	nenä
nothing	ei mikään
notice	huomata
notice, placard, poster	juliste
nought, zero	nolla
November	marraskuu
now, well, well then	no
nowhere	ei missään
nut	pähkinä
oats	kaura
obstinate, stubborn	itsepäinen
occasion, time	kerta
occupy, take	varata
ocean	valtameri
October	lokakuu
of course	tietysti
offer, propose, suggest	ehdottaa
officer, official	virkailija
oil	öljy
oil of olives, olive-oil	oliiviöljy
old	vanha
olive	oliivi
omnibus	bussi
one	yksi
onion	sipuli
opera	ooppera
opposition	vastustus
or	tai
orange	appelsiini
order	järjestys
organ	urut
other, another, else, second	toinen
outside, outside of	ulkopuolella
oval	soikea
overthrow, turn, turn over, upset	kumota
overture	alkusoitto
owe	olla velkaa
own, personal	oma
pace, step, stride	askel
Pacific, Pacific Ocean	Tyyni Valtameri
pack	pakata
paint	maalata
pair	pari
Pakistan	Pakistan
Pakistani	pakistanilainen
pale, sallow	kalpea
pants, trousers	housut
paper	paperi
parish	seurakunta
park	puisto
parrot	papukaija
parsley	persilja
part, piece, share, destiny, fate, fortune, luck	osa
pass, pass by	mennä ohi
pass, spend	viettää
path	polku
peace	rauha
peach	persikka
peak, point, tip, summit	kärki
peanut	maapähkinä
pear	päärynä
pearl	helmi
peat	turve
pedal	poljin
pencil	lyijykynä
pepper	pippuri
perish	tuhoutua
perplexed, taken aback	ymmällä
person	henkilö
persuade	suostuttaa
phase, stage	vaihe
phenomenon	ilmiö
philately, stamp-collecting	postimerkkeily
photograph	valokuva
photograph	valokuvata
physics	fysiikka
piano	piano
pick, stab, sting	pistää
piece of furniture	huonekalu
pig	sika
pike	hauki
pin, needle	neula
pine, pine tree	mänty
pious	hurskas
pipe	piippu
pirate	merirosvo
piston	mäntä
pizza	pizza
place, chamber, room	huone
plan	suunnitella
plane, aeroplane, airplane, air-plane	lentokone
plant	kasvi
plastic	muovi
plate	lautanen
platform, quay, wharf	laituri
platform, railway platform	ulkoportaat
play	leikkiä
plaza, square, public square	tori
please	miellyttää
plough	kyntää
plunder, rob	ryöstää
pocket	tasku
Pole	puolalainen
polka	polkka
poor	kurja
pork	sianliha
possible, contingent, eventual	mahdollinen
postage	postimaksu
potato	peruna
pour, scatter, shed	kaataa
pray	rukoilla
prefer	pitää parempana
premium, prize	palkinto
press, oppress, squeeze	puristaa
pressing, urgent	kiireellinen
price	hinta
private	yksityinen
probable	todennäköinen
probably	luultavasti
proceed	menetellä
profession	ammatti
profit	hyötyä
program, programme	ohjelmoida
promise	luvata
pronounce	ääntää
property, quality	laatu
property, quality	ominaisuus
protect	suojella
Protestant	protestanttinen
proud	ylpeä
prove	näyttää toteen
provisional, temporary	tilapäinen
public	yleisö
pump	pumpata
punish	rangaista
push, thrust, push along, shove	työntää
putrefy, rot	mädätä
quantity	määrä
quite, very, very much	sangen
quiver, shiver, tremble	vavista
rabbit	kani
radio, wireless	radio
radish	retiisi
raft	lautta
rag, scrap	repale
railroad, railway	rautatie
rain	sade
rain	sataa
rake	haravoida
raspberry	vadelma
rat	rotta
ray, strip, stripe	juova
re-	jälleen-
reaction	vastavaikutus
read	lukea
reality, truth	totuus
realm, state	valtakunta
reason, logical reasoning	järki
rebel, revolt	kapinoida
recall, recollect, remember	muistaa
recommend, register	suositella
record, register	kirjata
recruit	värvätä
red	punainen
reduce	supistaa
reef	luoto
regrettably, unfortunately	surukseni
relate, tell	kertoa
relative	suhteellinen
relative	sukulainen
relish	herkutella
remain, stay, stay over	jäädä
repeat	toistaa
repent	katua
report, review	selostaa
repose, rest	levätä
restaurant	ravintola
reverse, reversed	vastakkainen
rhyme	riimi
rhythm	rytmi
rice	riisi
rich, wealthy, well-off	rikas
ride	ratsastaa
right	oikeus
right, righthand	oikeanpuolinen
rigid, stiff	kankea
rigorous, stringent, severe, strict	ankara
ring	rengas
riot, tumult	mellakka
rip, tear	repiä
road, route, way	tie
roast, toast	paistaa
rock	kallio
rock, swing	keinuttaa
roe	mäti
roll	sämpylä
roll, roll up, wind, wind up	kääriä
romance	romanssi
romanticism	romantiikka
roof	katto
rose	ruusu
round	pyöreä
row	soutaa
rum	rommi
run	juosta
Russian	venäläinen
rust	ruoste
rustle, swish	suhista
sagacious, sage, wise	viisas
sail	purje
salary, wage, wages	palkka
salmon	lohi
salt	suola
same	samanlainen
sample, specimen	näyte
sand	hiekka
sandwich	voileipä
saturate	kyllästää
sausage	makkara
save, spare	säästää
saw	sahata
say, tell	sanoa
scale	asteikko
scar	arpi
scene	kohtaus
school	koulu
science	tiede
Scotland	Skotlanti
Scottish, Scotsman	skotlantilainen
scout, boyscout, boy scout	partiolainen
scrape, scratch	raapia
scratch	kynsiä
screw	ruuvi
sea	meri
seagull	lokki
season	vuodenaika
second	sekunti
secretary	sihteeri
see	nähdä
self, herself, himself, itself	itse
send, transmit	lähettää
sentence	lause
September	syyskuu
serve	palvella
set a trap, set a trap for	väijyä
seven	seitsemän
seventeen	seitsemäntoista
seventh	seitsemäs
seventy	seitsemänkymmentä
several	useahkot
sex	sukupuoli
shade, shadow	varjo
shake, shock	pudistaa
share	osake
shark	hai
sheep	pässi
sheet metal, tin, tin plate	pelti
shelf	hylly
shelter, protect	suojata
sherry	sherry
shine	loistaa
shine	valaista
ship, vessel	laiva
shirt	paita
shoe	kenkä
shoulder	hartia
shower	suihkuttaa
side, page	sivu
sill, threshold	kynnys
silver	hopea
simple, straightforward	yksinkertainen
sin, transgression	synti
sing	laulaa
sit	istua
six	kuusi
sixteen	kuusitoista
sixth	kuudes
sixty	kuusikymmentä
skin	iho
skirt	hame
sleeve	hiha
slug	etana
smell	haistaa
smoke	savuta
smooth	sileä
sneeze	aivastaa
snow	lumi
so, then, therefore	siis
soap	saippua
society	seura
sofa	sohva
soft	pehmeä
some	muutama
some kind of	jonkinlainen
somehow	jotenkin
someones	jonkun
son, boy	poika
sonata	sonaatti
songbook	laulukirja
soon	kohta
soot	noki
soul	sielu
sound, peal, ring	soida
soup	keitto
south	etelä
South Africa	Etelä-Afrikka
sow	kylvää
Spain	Espanja
Spanish, Spaniard	espanjalainen
sparrow	varpunen
speak, talk	puhua
spinach	pinaatti
spine	selkäranka
spirit	henki
spoon	lusikka
spring, springtime	kevät
square	neliö
squirrel	orava
stage, station, stop	asema
stair, step, rung	porras
stand	seisoa
star	tähti
state	valtio
station	rautatieasema
statue	patsas
steal	varastaa
steam, vapor, vapour	höyry
steel	teräs
still, yet	vielä
stock	varasto
stocking	sukka
stone	kivi
stork	kattohaikara
story, history	historia
stream, river	joki
strech, wind up	jännittää
street	katu
streetcar, tram	raitiovaunu
striking	osua
strong, intense, intensive	voimakas
struggle, wrestle	painia
study	opiskella
style	tyyli
subscribe, book, order, reserve	tilata
subtle	hienon hieno
succeed	menestyä
suffice	riittää
sugar	sokeri
summer	kesä
sun	aurinko
Sunday	sunnuntai
surprise	yllättää
swallow	pääskynen
swan	joutsen
swear	vannoa
sweat	hikoilla
Sweden	Ruotsi
Swedish, Swede	ruotsalainen
Swiss	sveitsiläinen
Switzerland	Sveitsi
sympathy	myötätunto
symphony	sinfonia
system	järjestelmä
table	pöytä
tail	häntä
talent	kyky
tame, train	koulia
tangerine	mandariini
taste	maku
tea	tee
teach	opettaa
tear	kyynel
telegraph	lennätin
telephone	puhelin
ten	kymmenen
tendency	taipumus
tension	jännitys
tent	teltta
terror	kauhu
than	kuin
thank	kiittää
that	että
that, that over there, those, that one, it	se
that, which, which one, who	kuka
the ... the	mitä ... sitä
them, they	he
them, they	ne
theme, topic, subject	aihe
then	silloin
there, thither	sinne
there, yonder	siellä
therefore	siksi
thigh	reisi
think	ajatella
third	kolmas
thirteen	kolmastoista
thirty	kolmekymmentä
this	tämä
thorn	piikki
though, although	vaikka
thousand, one thousand	tuhat
thread	lanka
three	kolme
thresh	puida
through	läpi
throw	heittää
thumb	peukalo
thunder	ukkonen
Thursday	torstai
tickle	kutittaa
time	aika
tiny	pikkuinen
tired	väsynyt
tobacco	tupakka
today, to-day	tänään
tomato	tomaatti
tomorrow	huomenna
tongue, language	kieli
too, too much	liiaksi
tooth	hammas
tooth-brush	hammasharja
tooth-paste	hammastahna
toothache	hammassärky
torture, abuse, torment	kiduttaa
touch	koskettaa
tourist	matkailija
trace, track	jälki
tradition	perinne
traffic	liikenne
train	juna
trample on, tread	tallata
translate, turn, turn around, turn round	kääntää
travel	matkustaa
tree, timber, wood	puu
triangle	kolmio
trill	liverre
trout	taimen
true	tosi
trumpet	torvi
trunk	matkalaukku
Tuesday	tiistai
tulip	tulppaani
tune	virittää
tunnel	tunneli
turkey	kalkkuna
Turkey	Turkki
Turkish	turkkilainen
turn	poiketa
turn	sorvata
twelve	kaksitoista
twenty	kaksikymmentä
two	kaksi
type	tyyppi
typeset	latoa
uncle	setä
understand, realise, realize	ymmärtää
undertake	yrittää
United Nations	Yhdistyneet Kansakunnat
United States of America, USA	Yhdysvallat
until	saakka
us, we	me
valley	laakso
value, worth	arvo
vanilla	vanilja
vary	vaihdella
vase, vessel	astia
veal	vasikanpaisti
vegetable	vihannes
verse	säe
vibrate	värähdellä
village	kylä
vinegar	ettika
violet	orvokki
violin	viulu
vision	näky
vodka	vodka
vote	äänestää
waiter	tarjoilija
wall	muuri
wall	seinä
walnut	saksanpähkinä
war	sota
warm	lämmin
wash	pestä
wasp	ampiainen
water	vesi
water-melon	vesimeloni
Watt	watti
wave	laine
weather	sää
weave	kutoa
Wednesday	keskiviikko
week	viikko
weigh, print	painaa
well-known	tuttu
west, West	länsi
whale	valas
what	mikä
what for, why	miksi
what kind of, what sort of	millainen
wheel	pyörä
when	milloin
where	missä
where ... to	minne
which one's, whose	kenen
whisky, whiskey	viski
whisper	kuiskata
whistle	viheltää
widow	leskirouva
widower	leski
willingly	mielellään
wind	tuuli
window	ikkuna
wine	viini
winter	talvi
with	kanssa
without	ilman
wolf	susi
woodpecker	tikka
wool	villa
word	sana
work	työskennellä
world	maailma
worm	mato
write	kirjoittaa
yacht	huvivene
yawn	haukotella
year	vuosi
yellow	keltainen
yes	kyllä
yesterday	eilen
yoghourt, yoghurt	jogurtti
yoke	ies
you	sinä
young	nuori
Yugoslav, Yugoslavian	jugoslaavi
Yugoslav, Yugoslavian	jugoslavialainen
Yugoslavia	Jugoslavia
zone	vyöhyke
