a	et
a few	noen få
a lot	mye
aback	bakk
abacus	kuleramme
abash	gjøre skamfull
abate, diminish	forminske
abbess	abbedisse
abbey	abbedi
abbot	abbed
abdicate	frasi seg
abdication	frasigelse
abdomen, belly, stomach, tummy	mave
abdomen, belly, tummy	buk
abduct	bortføre
abduct	kidnappe
abduction	bortføring
abduction	kidnapping
abductor	bortfører
abductor	kidnapper
aberration, deviation, departure	avvik
aberration, illusion	villfarelse
abet, aid, assist, help	hjelpe
abhorrence, loathing	vemmelse
abide	avvente
abide	holde fast ved
ability, capability	dyktighet
abject	ynke
able to	i stand til
ablebodied	arbeidsfør
abnormality	abnormitet
aboard	om bord
abolish	avskaffe
abomination	avskyelighet
aboriginal	opprinnelig
aborigines	urinnbyggere
abort	abortere
abortion	abort
abortion	misfoster
abortive	mislykket
about	circa
about	i nærheten
about	omkring
about	omtrent
about, if, in	om
abrasive	selvheftende
abridge	sammendra
abridge, abbreviate	forkorte
abridgement, abbreviation	forkortelse
abridgement, excerpt, extract	utdrag
abroad	utenlands
abrupt	plutselig
abrupt, bluff	bratt
abscess	byll
abscess, tumor, tumour, growth	svulst
abscond	stikke av
absence	fravær
absent	fraværende
absent minded	distrè
abundance	rikelig
abuse	misbruk
abuse	misbruke
abuse	skjelle ut
academic	akademiker
academic	akademisk
accede to	etterkomme
accede to, accommodate, cater	imøtekomme
accelerator	akselerator
accelerator pedal	gasspedal
accent	aksent
accent	uttale
accentuate	betone
accentuate	fremheve
accentuation	aksentuering
accentuation	betoning
accept	ta imot
acceptable	akseptabelt
acceptance	godtagelse
accepted	godkjent
accepted	godtatt
acceptor	akseptant
accession	tilgang
accession	tiltredelse
accessories, fittings	tilbehør
accessory	medskyldig
accessory, extra	ekstra
accommodate, adapt, conform	tilpasse
accomplish	fullføre
accord	innvilge
accord, compliance, compatibility	samsvar
accordance	overensstemmelse
according to	ifølge
accordingly, hence	følgelig
accordion	trekkspill
account	konto
accumulate	hope seg opp
accumulate, gather	samle
accuracy, exactness	nøyaktighet
ache	verke
acid	syre
acquaint	gjøre kjent
acquaintance	bekjentskap
acquisition	ervervelse
acquit	frikjenne
across, on the other side of	tvers over
activity	aktivitet
actor	skuespiller
actual, factual	virkelig
ad, advertisement	annonse
adamant	steinhard
adamant, inflexible	ubøyelig
adapt	bearbeide
add	legge til
addict, addicted	avhengig
addictive	avhengighetsskapende
address	adresse
adieu	adjø
adjacent	tilstøtende
adjust	instille
adjustment	instilling
administer	forvalte
administer, direct, govern	styre
administration	forvaltning
admire	beundre
admissible	tillatelig
admission, allowance	innrømmelse
admission, entry, entrance, access	adgang
admonish	påminne
admonish, exhort	formane
adolescent	halvvoksen
adorable	bedårende
adroit	behendig
adult, grown-up	voksen
adulter, adultress	ekteskapsbryter
advantage	fordel
adventure	opplevelse
adversary	motstander
advertise	kunngjøre
advertise	reklamere
aerial	luftig
aeroplane, plane, airplane	fly
affair	affære
affair, issue	sak
affect	berøre
affect, influence	påvirke
affiliate	knytte til
affirm, insure	forsikre
afflict	bedrøve
affliction	lidelse
affliction	prøvelse
affluence, influx	tilstrømning
afoot	til fots
afraid, coy, timid	sjenert
aft, abaft	akter
after, behind, subsequently, afterwards, next	bak
after, from	etter
afternoon	ettermiddag
age	alder
agency	agentur
agency	virksomhet
agglomerate	klumpe seg
aggravate	forverre
aggression	aggresjon
air	luft
air-mail	luftpost
airport	lufthavn
airport, airfield	flyplass
ale, beer	øl
all over again, again, once more, anew	igjen
all over again, anew, once more, again	pånytt
allow	tillate
allow, grant	innrømme
allowance	rasjon
allowance, discount	rabatt
almost, nearly	nesten
alone, solitary, sole, only	alene
also, too	også
altogether	aldeles
altogether	alt i alt
aluminium	aluminium
ambassador	ambassador
ambition	ærgjerrighet
ambitious	ærgjerrig
among, between	imellom
amplifier	forsterker
amplify, fortify, boost, intensify	forsterke
anchovy	ansjos
and	og
anger	sinne
anguish	kval
anguish, pain	pine
angular	vinkelformet
ankle	ankel
annex	tilføyelse
anniversary	årsdag
another	en annen
answer, respond, reply	svare
answering machine	telefonsvarer
ant	maur
antenna, ignite	antenne
anterior, formerly, former	tidligere
anthill	maurtue
anticipation	foregriping
anticipation	forutfølelse
anticipation, expectation	forventning
antidote	motgift
antique	antikk
anvil	ambolt
anxiety	engstelse
anxiety, disturbance	uro
apologetic	unnskyldende
appal	forskrekke
apparatus	apparat
apparently	tilsynelatende
appear	opptre
appear	vise seg
appendix	blindtarm
appendix	vedheng
apple	eple
appoint	fastsette
appoint	utnevne
appraise, evaluate	vurdere
apprentice, learner	lærling
approach	adkomst
approbation	bifall
approval	godkjenning
approve	godkjenne
approximate	omtrentlig
apricot	aprikos
April	april
aptitude, safety, security	sikkerhet
arbitrary	villkårlig
architect	arkitekt
ardent	brennende
ardent	ildfull
argue	argumentere
arm	arm
army	hær
arrangement	ordning
arrival	ankomst
arrive	ankomme
arrogance	hovmod
arrogant	hoven
arrow	pil
arson	brannstiftelse
arsonist, incendiary	brannstifter
art	kunst
artificial	kunstig
artisan	håndtverker
ascertain	finne ut
ascribe	tilskrive
ash-tray	askebeger
ask, enquire, inquire, quiz, ask	spørre
askance	på skjeve
asparagus	asparges
aspirin	globoid
assassin	snikmorder
assemble	komme sammen
assemble	montere
assent	samtykke
assert	hevde
assertion	påstand
assess	beskatte
associate	kollega
associate, liaison, connection, link	forbindelse
astonish	forbause
astonishing	forbausende
astound	forbløffe
astray	på villspor
astride	overskrevs
astute	slu
astute, acute	gløgg
asunder	i stykker
asylum	asyl
at present, now	nå
atrocious, dreadful, fearful, horrible	fryktelig
attach	knytte
attach	tillegge
attack	angrep
attack	angripe
attain, win, earn, gain	oppnå
attempt, try	forsøke
attend	betjene
attention	oppmerksomhet
attic	loft
attitude	holdning
attorney, advocate, lawyer, barrister	advokat
attribute	kjennetegn
audacious, foolhardy	dumdristig
audible	hørbar
August	august
aunt	tante
authentic	autentisk
authentic	ekte
author	forfatter
author	opphavsmann
authority, gouvernment	myndighet
automatic	automatisk
automobile, car, motor car, motor-car	bil
automoton	automat
autumn, fall, harvest, harvest	høst
available, available	disponibel
avarice	gjerrighet
avarice	griskhet
avenge	hevne
avenue	allé
average	gjennomsnitt
averse, loath	uvillig
avocation	bibeskjeftigelse
await, wait	vente
award	premie
awkward	keitet
awkward	klosset
awning	markise
awning	solseil
awry	forkjært
axe	øks
axis, axle	aksel
baby	spebarn
bachelor	ungkar
back	rygg
back	tilbake
background	bakgrunn
backpack, rucksack, knapsack	ryggsekk
backwards	baklengs
backwards	bakvendt
bacon	bacon
bacon	flesk
bacteria	bakterier
bad, nasty, poor, miserable	dårlig
baffle	forvirre
bag	pose
baggage, luggage	bagasje
baggy	posete
bagpipe	sekkepipe
bait	agn
bait	åte
bake	bake
baker	baker
bakery	bakeri
balcony	altan
balcony	balkong
bald	skallet
ball	ball
balloon	ballong
ballot	stemmeseddel
ballpoint pen	kulepenn
balm	balsam
balmy	skrullete
balmy, lenient, genial	mild
bamboo	bambus
banana	banan
bandage	bind
banish	forvise
bank	bank
banter	småerte
barb	brodd
barb	mothake
barbecue	grillfest
barbed wire	piggtråd
barber	barbermester
bargain	god handel
barge	lekter
barge	pram
barley	bygg
barn	låve
barracks	kaserner
barren	gold
barrow	trillebår
barter	byttehandel
basket	kurv
bat	balltre
bat	flaggermus
bath	bad
bathing suit	badedrakt
battery	batteri
battlefield	slagmark
bawl	brøle
bawl	skråle
bay	bukt
bay, inlet	vik
bazaar, market	torg
bazaar, warehouse	samvirkelag
be	være
be asleep, sleep, sleep	sove
beach	strand
beacon	sjømerke
bead, pearl	perle
beak	nebb
beam	ståle
beam, girder	bjelke
bean	bønne
bear	bjørn
beard	skjegg
beast	udyr
beastly	dyrisk
beastly, abominable, detestable, abhorrent	avskyelig
beautiful, fine	vakker
beautiful, judgement, fine	skjønn
beckon	vinke
bed, bed	seng
bedroom	soverom
bee	bie
beef	oksekjøtt
beet	bete
beetle	bille
beggar	tigger
behold	skue
behold, see, look, glance	se
beige	beige
being	skapning
belch	oppstøt
belch	rap
belligerent	krigførende
below, beneath, under	under
bench	benk
benefaction	velgjerning
benefit	gode
benevolent	velvillig
bent, curved	buktet
bequeath	testamentere
berth	ankerplass
besiege	beleire
bestow, grant, give	skjenke
bet, wager	vedde
betray	forråde
betroth	forlove
better	bedre
bewitch	forhekse
beyond	hinsides
bib	smekke
bicycle, bike, cycle	sykkel
bier	båre
big, large	stor
bigot, zealot, fanatic	fanatiker
bilberry	blåbær
billiards	biljard
binoculars	kikkert
bird	fugl
birth	fødsel
bitch	tispe
bitter	bitter
black	svart
black frost	barfrost
bladder, bubble	blære
blame	klandre
blanket	ullteppe
bleach	blekemiddel
bleat	breke
bleed	blø
blemish	skavank
blemish	skjemme
blend, mingle, shuffle, mix	blande
bless	velsigne
blind	blind
blind alley, cul-de-sac	blindvei
bliss	lykksalig
blister	blemme
blizzard	snøstorm
bloated	oppsvulmet
blond	blond
blood	blod
blot	flekk
blot	klatt
blouse	bluse
blowfly	spyflue
blubber, lard	spekk
blue	blå
blueprint	blåkopi
bluff	steil
bluff, fierce, harsh, gruff	barsk
blunder	bommert
blunt	likefram
blur	dimme
blush, flush	rødme
boar	villsvin
boast, brag	skryte
boat	båt
body	legeme
bog	myr
boil	koke
boisterois	støyende
bomb	bombe
bonnet	panser
book	bok
bookshop	bokhandel
borrow	låne
bosom	barm
bosom, chest, breast	bryst
bother	bryderi
bottle, flask	flaske
bouillon	buljong
boulder	kampestein
bounce	bykse
bounce	sprette
boutique, business, commerce, store, shop, trade	forretning
bowels	tarmer
bowels, entrails	innvoller
boy, lad	gutt
bra	bysteholder
bracelet	armbånd
braces, suspenders	bukseseler
brain	hjerne
braindead	hjernedød
brake lining	bremsebelegg
branch	gren
brandy, liquor	brennevin
brass	messing
brave	tapper
brave, courageous, gritty	modig
brawl	klammeri
brawl, fight	slagsmål
bread, loaf	brød
breadwinner	familieforsørger
breakable, fragile, brittle	skjør
breakfast	frokost
breath	pust
breath	ånde
brick	murstein
bride	brud
bridge	bro
bridle	bissel
bridle	tøyle
briefcase	dokumentmappe
brim	rand
bring	bringe
brisk, lively	livlig
broad	bred
broad-minded	tolerant
broad-minded	vidsynt
broadcast	kringkaste
broke	blakk
broker	mekler
bronchitis	bronkitt
bronze	bronse
brooch	brosje
brook	bekk
broom	kost
broom	sopelime
broth	kjøttkraft
broth, gravy	sjy
brother	bror
brother-in-law	svoger
brown	brun
brush	børste
bucket	bøtte
bucket	spann
buckle	spenne
buffet	bar
buffoon	bajas
building	bygning
bullet	kule
bulwark	skansekledning
burden	byrde
bureau	byrå
burglar	innbruddstyv
burial, funeral	begravelse
burrow, den, lair	hule
bury	begrave
bus stop, busstop	buss-stopp
bustle	travelhet
busy	travel
busy, engaged, busy	opptatt
butcher	slakter
butler, headwaiter	hovmester
butter	smør
butterfly	sommerfugl
buttock	rumpeballe
button	knapp
buxom	trivelig
buxom, lush	yppig
bye, adieu, goodbye, good-bye	farvel
cab-stand	drosjeholdeplass
cabaret	kabaret
cabbage	kål
cabin	hytt
cabin	kahytt
cabin	lugar
cable, hawser	kabel
cackle	kakle
cackle, quack	snadre
cafe	kafé
cairn	varde
cake	kake
calculation, bill	regning
calendar	kalender
calf	kalv
calf	legg
calico	bomullslærret
call box, telephone booth, telephone kiosk	telefonkiosk
call, summon	kalle
callisthenics	holdningsgymnastikk
callous, harsh, hard	hard
calm	vindstille
calm, quiet, easy	rolig
camel	kamel
camera	fotoapparat
camera	kamera
camping ground, camping site	leirplass
camshaft	kamaksel
canal, channel	kanal
cancer	kreft
candid, frank, ingenuous	oppriktig
candle, light	lys
canopy	baldakin
canyon	juv
canyon	slukt
capacity	kapasitet
capsule	kapsel
captain	kaptein
caption	billedtekst
carburettor	forgasser
carcase	kadaver
cardboard	kartong
cardigan	strikkerjakke
caress, fondle	kjærtegne
carnation	nellik
carnivorous	kjøttetende
carpenter	snekker
carpet, blanket	teppe
carriage, carriage, wagon, railway carriage, coach	vogn
carrion	åtsel
carrot	gulrot
carry, wear	bære
cartridge	patron
carve	hogge ut
carve, cut, slice	skjære
cascade	liten foss
casette-player	kasett-spiller
cash money	kontanter
cashier	kasserer
castaway	skibbrudden
castle, palace	slott
castor-oil	lakserolje
cat	katt
catalogue	katalog
catch	oppfatte
catch, grab, grapple, grasp, capture, grip	gripe
catch, incur	pådra seg
caterpillar	gravemaskin
cathedral	domkirke
cathedral, cathedral	katedral
cattle	storfe
cauldron, kettle, boiler	kjele
cauliflower	blomkål
caution, caution	forsiktighet
cautious	varsom
cautious, careful, cautious, guardedly	forsiktig
cavern	stor hule
cavern, cave, grotto, den	grotte
cavity	hulrom
cd-player	cd-spiller
cease, decrease, lessen, decline	avta
cease, fold up	opphøre
cellar, basement	kjeller
center	sentrum
central heating	sentralvarme
century, centennial	århundre
ceremonial	seremoniell
certain	sikker
certain	viss
certificate	attest
certificate	sertifikat
chain	kjede
chair	stol
chairman	formann
chalk	kritt
challenge	utfordring
chamber, room	værelse
chamber, room, space	rom
chandelier	lysekrone
change	forandre
change	veksle
chant	messe
chant	sang
chap	kar
chap	sprekk
chap, beacon	fyr
chapter	kapitel
charcoal	trekull
charitable	nestekjærlig
charity	nestekjærlighet
charity	veldedighet
charwoman	vaskehjelp
chase, hound	jage
chauvinism	sjåvinisme
cheat	jukse
check, cheque	sjekk
checkers	damspill
cheek, cheek	kinn
cheeky	frekk
cheese	ost
chemist's shop, drugstore	apotek
chemistry	kjemi
chequered, checked	rutet
cherish	sette høyt
cherish	verne om
cherry	kirsebær
chervil	kjørvel
chess	sjakk
chew	tygge
chewing gum	tyggegummi
chicken, chick	kylling
chicken, hen	høne
chief	høvding
child	barn
chiropodist	fotpleier
chisel	meisel
chivalrous	ridderlig
chive	gressløk
chocolate	sjokolade
choke	kvele
chop, hew	hogge
christen	døpe
christening	dåp
christmas	jul
Christmas eve	julaften
chronological	kronologisk
chubby	lubben
cigar	sigar
cigarette, fag	sigarett
cinder	slagg
cine	smalfilm
cinema, movie theatre	kino
circle	sirkel
circuit	omkrets
circumcise	omskjære
circumference	periferi
circumstance	omstendighet
citizen	borger
city, town	by
clam	musling
clammy, humid, damp	fuktig
clamorous	larmende
clamp	spenne fast
clamp, hug, cuddle	klemme
clasp, hook	hekte
clavicle	krageben
clay	leire
clean, pure	ren
clench	presse sammen
clerk	kontorist
client	klient
cliff	skrent
climate	klima
climb	klatre
clinch, hug, embrace, clasp	omfavne
clock	ur
clock, bell	klokke
clog	tresko
clothes	klær
clothing	kledning
cloud	sky
clove	fedd
clover, shamrock	kløver
cluster	hop
coach	trener
coal, hatch, litter	kull
cobble	brolegge
cobble	reparere
cobweb	spindelvev
cock	hane
cockroach	kakerlakk
cocoa	kakao
cocoon	kokong
codfish	torsk
codliver oil	tran
coffee	kaffe
coffee-machine	kaffetrakter
coffeegrounds	kaffegrut
coffin	kiste
cogwheel	tannhjul
cohabitant	samboer
cohesive	sammenhengende
coil	kveil
coil	spiral
coin	mynt
coincidence	sammentreff
colander	dørslag
colitis	tykktarmbetennelse
collaborate	samarbeide
collapse	sammenbrudd
collar	krage
collar	snipp
collection, assemblage	samling
colon	tykktarm
colonel	oberst
colt, foal	føll
column	kolonne
column	søyle
comb	kjemme
combustible	lett antennelig
combustion, incineration	forbrenning
come	komme
come to an end, expire, expire, end	utløpe
comedian	komiker
comfort, convenience	bekvemmelighet
commence, begin, start	begynne
commend	anbefale
commend	rose
commission, errand, mission	oppdrag
common	felles
common	vanlig
common, general	alminnelig
communication-cord	nødbremse
commute	pendle
compact disc	kompakt disk
compass	kompass
compassion	medlidenhet
compatibility	forenlighet
compatriot	landsmann
compelling	tvingende
compensate	erstatte
compensate	kompensere
compete	konkurrere
competition	konkurranse
complacency	selvtilfredshet
complacent	selvtilfreds
complaisant, docile	føyelig
complex	sammensatt
complexion	hudfarge
complicate, entangle	komplisere
complicity	delaktighet
concerned	bekymret
concert	konsert
conciliate, accord	forsone
conciliation	forsoning
concise	konsis
concise	kortfattet
concord, accord	enighet
concrete	betong
concrete	konkret
concur	stemme overens
concurrent	sammenfallende
concussion	hjernerystelse
condemn	kondemnere
condescend	nedlate seg
condescending	nedlatende
condition	betingelse
condition	tilstand
cone	kjegle
confectionery	konditori
confederacy, federation, league	forbund
confess	skrifte
confess	tilstå
confirm, affirm	bekrefte
confirmation	bekreftelse
confounded	forbasket
congeal	størkne
congestion	opphopning
congratulate	gratulere
conic	kjegleformet
conifer, conifer	nåletre
conjure	trylle
conquer	seire
conquer, capture	erobre
conscience	samvittighet
conscious	bevisst
consciousness	bevissthet
conscript	verneplikt
consecrate	vigsle
consequence	konsekvens
conservation	bevaring
consider	overveie
considerable	betydelig
considerate	hensynsfull
consideration	hensyn
consideration	overveielse
consist	bestå
consolidate	trygge
conspicuous	iøynefallende
conspiracy	sammensvergelse
constable	konstabel
consternation	forskrekkelse
constipate	forstoppe
constipation	forstoppelse
constituency	valgkrets
constrained	anstrengt
consulate	konsulat
contact	kontakt
contagous, infectious	smittsom
contaminate	forurense
contamination	forurensning
contemporary	samtidig
contempt	forakt
context, coherence	sammenheng
continent	kontinent
continent	verdensdel
continue	fortsette
contraception	prevensjon
contraction	sammentrekning
contradict	motsi
contradiction	motsigelse
contrary	motsatt
contribute	bidra
contrivance	påfunn
convenient	bekvemt
conversion	forvandling
convey	føre
convey, impart	formidle
convict, catch, catch, capture, grapple	fange
convince	overbevise
cool	kjøle
cool	kjølig
copper	kopper
copperplate	kopperstikk
copulate	pare seg
copy	avskrift
copy	kopi
core, gist, churn, heart	kjerne
cork	kork
cork	korke
corkscrew	korketrekker
cornea	hornhinne
corner	hjørne
cornet, biscuit	kjeks
coronation	kroning
corpuscle	blodlegeme
correct	korrigere
correct	rette
correct, right	riktig
corrode	ruste
corrosion	korrosjon
corrosion, rust	rust
corrosive	etsende
corrugate	bølge
corrugate	rifle
corrugated iron	bølgeblikk
corrupt	fordervet
corrupt	korrupt
cosy	koselig
cot	barneseng
cotdeath	krybbedød
cottage	lite hus
cotton, wadding	bomull
cough	hoste
council	forsamling
council, advice	råd
count	telle
count, earl	greve
counteract	motvirke
counterbalance	motvekt
counterfeit, adulterate, fake, falsify	forfalske
counterfeit, falsification, fake	forfalskning
counterpart	motstykke
countess	grevinne
countryman, farmer, peasant	bonde
county	fylke
coupe, compartment	kupé
couple, pair	par
courage, from, grit, across from, opposed to	mot
course	bane
course	kurs
course, lapse	forløp
court	domstol
courteous	høflig
courteoussy	høflighet
cousin	fetter
cover	skjul
cover, jacket	omslag
cover, lid	deksel
covetous, hungrily	begjærlig
cow	ku
coward	feiging
cowardice	feighet
cowberry	tyttebær
crab	krabbe
crackle	knitre
crackle	sprake
cradle	vugge
cram	pugge
cram	stappe
cramp	krampe
cranberry	tranebær
crane	kran
crane	trane
crank	sveiv
crankshaft	veivaksel
crate, money box, money-box, cashier's stand, till	kasse
crayfish	kreps
craze	mani
creak	knirke
cream	fløte
create	skape
creation	skapelse
creativity	kreativitet
creativity	skaperevne
creator	skaper
credibility	troverdighet
credit	kreditt
credulous, gullible	godtroende
creed	trosbekjennelse
cremate	kremere
crescent	halvmåne
crescent	halvmåneformet
cress	karse
crew	mannskap
crick	forstrekke
crick	kink
cripple	krøpling
crisis	krise
crisp, crazy, freaky, brittle	sprø
croak	kvekke
crockery	stentøy
crockery set	servise
cross	kors
cross, intersect	krysse
crossroads	veikryss
crotch	skritt
crouch	krøke sammen
crow	kråke
crowbar	brekkjern
crowded	overfylt
crucial, decisive	avgjørende
crucifixion	korsfestelse
cruel	grusom
cruelty, atrocity	grusomhet
crumb	smule
crunch	knase
crush	knuse
crust	skorpe
crust, host	skare
crutch	krykke
cry	grine
cry	gråte
cube, dice	terning
cuckoo	gjøk
cucumber	agurk
cucumber	slangeagurk
cue, queue	kø
culprit	gjerningsmann
cultivate	kultivere
cultivate, grow	dyrke
cultural	kulturelt
cumbersome	besværlig
cunning	utspekulert
cup	kopp
cupboard	kjøkkendisk
curable	helbredelig
curb, kerb	fortauskant
curettage	utskrapning
curfew	portforbud
curiosity	nyskjerrighet
curious, inquisitive	nyskjerrig
curl, crumple	krølle
curler	papiljott
currency	valuta
current	aktuell
curriculum	pensum
curriculum	undervisningsplan
curse	forbanne
curse	forbannelse
cursor	markør
curt	brysk
curtail	skjære ned på
curtain	gardin
curve	kurve
curve	sving
cushion	pute
custard	vaniljesaus
custom	skikk
custom-house	tollbod
custom-house	tollkontor
customer	kunde
cutler	knivsmed
cutlet	kotelett
cuttle	blekksprut
cylinder phonograph, gramophone	grammofon
cylinder, roller	sylinder
cynic	kyniker
cynical	kynisk
daffodil	påskelilje
dagger	dolk
daily	daglig
dairy	meieri
daisy	tusenfryd
damp, clammy	klam
dance	dans
dandelion	løvetann
dandruff	flass
dandy	laps
danger, jeopardy, peril, hazard	fare
dangerous	farlig
dangle	dingle
Danish	Dansk
dare, hazard	våge
daring	dristig
daring	vågal
dark	mørk
dark	mørkt
dark blue	mørkeblå
darken	mørkne
darkness	mørke
darling	elskling
dash	skvett
date	daddel
date, rendezvous, accommodation, agreement, fix	avtale
daub	klatte
daub	smøreri
daughter	datter
daunting	skremmende
dawn	daggry
day	dag
dazed	omtumlet
dead, death	død
deaf	døv
deafening	øredøvende
deafmute	døvstum
deafness	døvhet
deal	handel
dear	kjær
dear, expencive, valuable, pricey, expensive	kostbar
death	døden
debark, disembark	landsette
debate	debatt
debit	debet
debt	gjeld
debtor	debitor
decade	tiår
decadent	i forfall
decanter	karaffel
decay	forråtnelse
deceit, imposition, deception	bedrag
December	desember
decency	sømmelighet
decent	skikkelig
decent	sømmelig
deceptive	villedende
decipher	omsette
decision	avgjørelse
declaration	erklæring
declare	erklære
decline, decrease	nedgang
decorate	dekorere
decoration	dekorasjon
decoration, finery	pynt
decoy	lokkefugl
decrease	redusere
decree	forordne
decrepit	avfeldig
dedicate	tilegne
dedication	tilegnelse
deduce, derive	utlede
deduce, quit	slutte
deduct, discount	trekke fra
deduction	fradrag
deed	gjerning
deer, hart	hjort
defeat	nederlag
defect	hoppe av
defection	avhopp
defector	avhopper
defence	forsvar
defend, justify	forsvare
defendant	saksøkt
defensive	defensiv
defensive	i forsvar
defiance	trass
defiant, dogged	trassig
deficient, defective, imperfect, faulty	mangelfull
deficit	underskudd
define	definere
definite	bestemt
definition	definisjon
definitive	definitiv
deflect	bøye av
deforest	avskoge
deforestation	avskoging
deform	misdanne
deformed	misdannet
deformed	vanskapt
deformity	misdannelse
defrost	avrime
deft	netthendt
defuse	uskadeliggjøre
defy	utfordre
defy, hawser	trosse
degenerate	utarte
degeneration	utarting
degradation	degradering
degrade	degradere
degrade	fornedre
degree, examination	eksamen
degree, grade	grad
dejected, low	nedslått
delay	forsinke
delay	utsettelse
delegate	delegere
deliberate	overlagt
delicacy	finfølelse
delicacy	lekkerbisken
delicate	fintfølende
delicate	sart
delicate, dainty	delikat
delicious, lovely	deilig
delightful	herlig
delinquency	lovovertredelse
deliquent	lovovertreder
delirious	feberfantasere
delivery	levering
delude	villede
delude, frame, dupe, fool	narre
delusion	vrangforestilling
delusion, illusion	illusjon
demand	etterspørsel
demand	krav
demand, claim	fordre
demand, claim	kreve
demeanour, conduct, deportment, behaviour	oppførsel
democracy	demokrati
demolish	rive ned
demolition	nedriving
demonstrate	demonstrere
demure	anstendig
denial	avslag
denial	benektelse
denigh	nekte
denounce	angi
denounce, condemn	fordømme
denounce, discredit, flunk	avvise
dense	dum
dense	tett
density	tetthet
dent	bulk
dent	bulke
dental floss	tanntråd
dentalist, dentist	tannlege
denture	gebiss
denunciation	angiveri
denunciation	fordømmelse
deny	benekte
deny, decline	avslå
depart	avgå
departed, deceased	avdød
department	departement
Department of Justice	justisdepartementet
department, branch, section, compartment	avdeling
departure	avgang
depend	avhenge
depend	stole på
dependable	pålitelig
dependence	avhengighet
depict	avbilde
depict	skildre
depletion	tømming
depletion	uttynning
deplorable, lamentable	beklagelig
deplore, lament	beklage
depopulate	avfolke
deport	deportere
depose	avsette
depose	vitne
deposit	avleiring
deposit	deponere
deposit	depositum
deposit	innskudd
depreciate	nedvurdere
depreciate	synke i verdi
depreciation	avskrivning
depreciation	verdiforringelse
depress	trykke ned
depressed, glum	nedtrykt
depression	depresjon
depression	nedtrykking
deprive, dispossess	berøve
depth	dybde
deputize	vikariere
deputy	stedfortreder
derail	spore av
derailment	avsporing
derision	hån
derogatory	nedsettende
derrick	boretårn
derrick	lastebom
derrick	lossebom
descend	stamme fra
descend	stige ned
descendant	etterkommer
describe	beskrive
description	beskrivelse
description	signalement
desecrate	skjende
desecrate	vanhellige
desert	desertere
desert	ørken
desertion	desertering
deserving	fortjenstfull
desirable	ønskelig
desire	begjære
desire	ønske
desire, lust	begjær
desk	pult
desk	skranke
desolate	ulykkelig
desolate, gaunt	øde
despair	fortvile
despair	fortvilelse
desperate	desperat
desperate, despairing	fortvilet
despite	til tross for
despite, grudge	nag
despondency	motløshet
despondent	motløs
dessert	dessert
destination	bestemmelsessted
destined	forutbestemt
destiny, fortune, lot, fate	skjebne
destitute	nødlidende
destitute, devoid	blottet for
destitution, distress	nød
destroy, devastate	ødelegge
destruction, havoc	ødeleggelse
destructive	ødeleggende
detach	ta av
detached	frittliggende
detached, disconnected	frakoplet
detachment	løsgjøring
detail	detalj
detailed	detaljert
detailed	inngående
detain	holde tilbake
detain	oppholde
detect, discover	oppdage
detective	detektiv
detention	arrest
detention	forvaring
detergent	vaskemiddel
deteriorate	forverres
determination	besluttsomhet
determination	bestemmelse
determine, decide	bestemme
detixification	avvenning
detonation	detonasjon
detour	omvei
detoxify	av-gifte
detrimental, harmful, injurious	skadelig
devaluation	devaluering
devalue	devaluere
devastate	herje
develop	utvikle
development	fremkalling
development, generation	utvikling
deviate, depart, deflect	avvike
devious	underfundig
devise	tenke ut
devoid, disengaged, free	fri
devote	vie
devoted	hengiven
devotion	fromhet
devotion, affection	hengivenhet
dew	dugg
dew	dugge
dexterity	behendighet
dexterous	hendig
diabetes	sukkersyke
diabetic	diabetiker
diagnose	diagnostisere
diagnosis	diagnose
diagram, plane, map, plan, design	bykart
dial	nummerskive
dial	slå telefonnummer
dial	urskive
dialect	dialekt
dialect	målføre
dialling code	retningsnummer
dialling tone	summetone
diamond	diamant
diaphragm	blender
diaphragm	mellomgulv
diaphragm	pessar
diarrhoea	diaré
diary, journal	dagbok
didactic	belærende
didactic	didaktisk
die, depart	dø
diet	diett
differ	være forskjellig
difference, distinction, disparity	forskjell
different	forskjellig
diffuse, dissipate, disperse, dispel	spre
diffusion, dissipation	spredning
digest	fordøye
digestible	førdøyelig
digestion	fordøyelse
dignified	ærverdig
dignity	verdighet
digress	komme bort fra emnet
dike, embankment, dam	demning
dilapidated	falleferdig
diligence	flid
dilute	fortynne
dimension, gauge	dimensjon
diminution	forminskelse
dimple	smilehull
din	bråke
dingy	snusket
dining-car	spisevogn
dining-room	spisestue
dining-table	spisebord
diocese	bispedømme
dip	dukkert
dip, immerse	dyppe
dipper	nedblendingskontakt
dipswitch	dimbryter
direct	direkte
direct	rettlede
direct-current	likestrøm
direction	retning
direction, lead, leadership	ledelse
director	direktør
director	styremedlem
directory	adressebok
disability	uførhet
disadvantage, inconvenience	ulempe
disadvantageous	ufordelaktig
disagree	ikke stemme overens
disagree	være uenig
disagreeable	ubehagelig
disappear	forsvinne
disappearance	forsvinning
disappoint	skuffe
disappointed	skuffet
disappointment, frustration	skuffelse
disarm	avvæpne
disarm	nedruste
disarmament	avvæpning
disarmament	nedrustning
disassembly	demontering
disaster, calamity	katastrofe
disastrous	katastrofal
disastrous	ulykksalig
disbelief	tvil
disbelief, infidelity, infidel, incredulous	vantro
disbelieve, distrust	mistro
discdrive	diskettstasjon
discern, distinguish	skjelne
discerning, canny, ingenious	skarpsindig
discerning, judicious	forstandig
discharge	avmønstring
discharge	løslatelse
discharge	utskrivning
disciple	disippel
discipline	disiplin
discipline	disiplinere
disclaim	dementere
disclaim	fraskrive seg
disclose	avsløre
disclose	røpe
disclosure, exposure	avsløring
discomfort	ubehag
disconcerted	forvirret
disconnect, detach	kople fra
disconsolate, inconsolable	utrøstelig
discontented, dissatisfied	misfornøyd
discontinue	holde opp med
discord	disharmoni
discord	dissonans
discord, disagreement, dissension	uenighet
discourage	ta motet ifra
discourteous, impolite	uhøflig
discoverer	oppdager
discovery	oppdagelse
discredit	vanry
discreet	diskrèt
discreet	taktfull
discrepancy, disagreement, incongruity	uoverensstemmelse
discretion	diskresjon
discriminate	diskriminere
discrimination	diskriminering
discuss	diskutere
discuss, argue	drøfte
discussion	diskusjon
discussion	drøfting
discussion	forhandling
disease, illness	sykdom
diseased	sykelig
disembark	gå i land
disembark	utskipe
disentangle	greie ut
disentangle	vikle ut
disfigure	vansire
disgrace	unåde
disguise	maskere
disguise, apron	forkle
dish cloth	oppvask-klut
dishonesty	uærlighet
dishonour	skam
dishonour, disgrace	vanære
dishwasher	oppvaskmaskin
disillusion	desillusjonere
disinclined, indisposed	utilbøyelig
disinfect, fumigate	desinfisere
disinfectant	desinfeksjonsmiddel
disinfection	desinfeksjon
disinherit	gjøre arveløs
disintegrate	nedbryte
disintegrate, dissolve	oppløse
dislike	ikke like
dislike	motvilje
dislocate	bringe av ledd
dislocate	forrykke
dislocation	forvridning
disloyal	illojal
dismay, horror	forferdelse
dismiss	avskjedige
dismiss	sende bort
dismissed	avskjediget
dismount	stige av
dismount, disassemble, dismantle	demontere
disobedience	ulydighet
disobey	være ulydig
disorder	uorden
disorderly	uordentlig
disown	fornekte
disown	ikke kjennes ved
disparity, inequality	ulikhet
dispatch	avsendelse
dispatch	ekspedere
dispatch	rapport
dispatch-note	følgebrev
dispel	jage bort
dispensable	unnværlig
dispensation, distribute	dele ut
dispensation, distribution	utdeling
displace	flytte på
displacement	forskyvning
display	oppvisning
display, exposition, exhibition	utstilling
disposable	engangs-
disproportion	misforhold
disputable	diskutabel
disputed	omstridt
disquieting	foruroligende
disregard	ignorering
disreputable, infamous	beryktet
disrespect	mangel på aktelse
disrespectful, irreverent	uærbødig
dissatisfaction, discontent	misnøye
dissimilar	ulik
dissipate	ødsle
dissipation	ødsling
dissolvable	oppløselig
distance	distanse
distance, offset	avstand
distaste	avsmak
distil	destillere
distillation	destillasjon
distinct	adskilt
distinction	utmerkelse
distinctive	særegen
distinguish	utmerke
distinguished	anerkjent
distinguished	fornem
distort	fordreie
distort	fortegne
distort	forvrenge
distortion	forvrengning
distract	distrahere
distracted	forstyrret
distraction	distraksjon
distraction	forvirring
distraint	utpantning
distress	bekymre
distress	bekymring
distribute	fordele
distribution	fordeling
distributor	fordeler
distributor	forhandler
distrust	mistillit
ditch	grøft
diuretic	vanndrivende
dive	dykk
dive	dykke
dive	stup
dive	stupe
diver	dykker
diverse	diverse
diversion	adspredelse
diversion	avledning
diversion	omkjøring
divert	adspre
divert	omdirigere
divert, derive, distract	avlede
divide	dele
divide	dividere
divide	skille
divinity	guddommelighet
divinity	teologi
division	deling
division	divisjon
divorce	skildmisse
divorce	skilles
dizziness	svimmelhet
do, execute	utføre
dock	anklagebenk
dock	dokk
docker	havnearbeider
dockland	dokkområde
doctor	doktor
doctor, physician	lege
document	dokumentere
documentary	dokumentar
dodge	smette unna
dog	hund
dogged	seig
dole	arbeidsledighetstrygd
dolphin	delfin
dome	kuppel
domestic, inland	innenriks
domicile	bopel
dominate	dominere
domination, dominion	herredømme
donation	donasjon
done	gjort
done	utført
donkey, ass	esel
donor	donor
donor	giver
doom	undergang
doomsday	dommedag
door	dør
doorhandle	dørklinke
doorknob	dørhåndtak
doorway	døråpning
dope	narkotikum
dope, drug	dop
dove, pigeon	due
dowager	enke
downloading	nedlasting
downstairs	nedenunder
downwards	nedover
dowry	medgift
doze	døse
doze	slumre
dozen	dusin
drab, dull, dreary	trist
drab, humdrum	ensformig
draft	utkast
draft	veksel
drag	trekke
dragnet	slepenot
dragon	drake
dragonfly	øyenstikker
drain	avløp
drain	drenere
dramatic	dramatisk
drape	drapere
draught, gulp	slurk
drawer	skuff
drawing, design	tegning
drawl	snakke med slepende tonefall
dread	frykt
dread, fright	skrekk
dream	drøm
dream	drømme
dreamy	drømmende
dredge	muddermaskin
dredge	mudre
dregs	berme
dregs	bunnfall
drenched	gjennomvåt
dress	antrekk
dress	kle seg
dressing gown	slåbrok
dressingcase	toalettmappe
dressmaker	sydame
drift	drive
drill	bor
drill	drill
drill	eksersis
drip	drypp
drip	dryppe
drip	dråpe
dripfeed	intravenøs næring
driver	fører
driver, conductor, chauffeur	sjåfør
drivers-licence	førerkort
drizzle	duskregn
droll, funny	pussig
drool	sikkel
drool	sikle
droop	henge ned
drown	drunke
drowsy	døsig
drowsy	søvnig
drug	bedøve
drug	legemiddel
drug-pusher	stofflanger
druggist, chemist	apoteker
drum	tromme
drunk, full	full
drunkard	drukkenbolt
dry	tørr
dry, drought	tørke
dual	dobbel
dubious, questionable	tvilsom
duchess	hertuginne
duchy	hertugdømme
duck	and
duck, dip, doll	dukke
due	forfallen
due to	på grunn av
due, guilty	skyldig
duel	duell
duel	duellere
duke	hertug
dull, blunt, languid	sløv
dull, dim, faint	matt
dull, drag, boring, dreary, humdrum, tiresome	kjedelig
dumb, speechless, mute	stum
dumbfounded	forbløffet
dumbfounded	målløs
dump	dumpe
dump	søppelhaug
dumping	avlessing
dumping	dumping
dumpling	melbolle
dune	sandbanke
dung	naturgjødsel
dupe	lettlurt
dupe, con, humbug	lure
duplicate	dobbelt
durability	holdbarhet
durable	holdbar
durable, lasting	varig
duration	varighet
during	i løpet av
dusk, twilight	skumring
dust	støv
duster	støvkost
Dutch	Nederlandsk
dutiable	tollpliktig
dutiful	lydig
dutiful	pliktoppfyllende
duty	plikt
duty, customs	toll
dutyfree	tollfri
dwell	dvele
dwell, estate, live	bo
dwindle	svinne
dye	fargestoff
dying	døende
dynamic	dynamisk
dynamics	dynamikk
dynamite	dynamitt
each	hver enkelt
each, all, everyone, everybody	alle
eachother	hverandre
eagerness, zeal	iver
eagle	ørn
ear	øre
earache	øreverk
eardrum	trommehinne
earflap	ørebeskytter
earl	jarl
earlobe, earlobe	øreflipp
early	tidlig
earn, deserve	fortjene
earn, fetch	innbringe
earn, gain, win	vinne
earnings	inntekter
earphones, headphones	høretelefoner
earplug	ørepropp
earring	øredobb
earth	jord
earthquake, earthquake	jordskjelv
earthworm	meitemark
ease	slakke
ease, facility	letthet
ease, gusto	velbehag
ease, lighten, facilitate, lift	lette
easel	staffeli
east	øst
Easter	Påske
eastern	østlig
easy	behagelig
easy, light	lett
easychair, arm-chair	lenestol
easygoing	omgjengelig
eat	fortære
eatables	matvarer
eaves	takskjegg
eavesdrop	smuglytte
ebb	ebbe
ebb	fjære
ebb, lessen, decrease	minke
ebony	ibenholt
EC	EU
ecclesiastic(al)	geistlig
ecclesiastic(al)	kirkelig
echo	ekko
eclipse	eklipse
eclipse	formørkelse
ecological	økologisk
ecology	økologi
economic, financial	økonomisk
economics, economy	økonomi
ecstasy	ekstase
ectopic	ektopisk
eddy	evje
eddy	virvel
edge, brim	kant
edge, egg	egg
edgeways	sidelengs
edible, eatable	spiselig
edifice	byggverk
edifying	oppbyggelig
edit	redigere
edition	utgave
edition, impression	opplag
editor	redaktør
editor	utgiver
editorial	lederartikkel
educate	utdanne
education	utdannelse
eel	ål
eelpot	åleteine
effect	effekt
effect	virkning
effective	virksom
effective, efficient	effektiv
effects	effekter
effects	eiendeler
effeminate, feminine	feminin
efficiency	effektivitet
effort	anstrengelse
effusion	utgytelse
effusive, exuberant	overstrømmende
egoism	egoisme
egoist	egoist
egoistic	egoistisk
egotism	selvopptatthet
eider	ærfugl
eight	åtte
eighteen	atten
eighth	åttende
eighty	åtti
either	hvilken som helst
eject	støte ut
eject, expel, dispossess	fordrive
ejector seat	katapultsete
elaborate	utarbeide
elaboration	utarbeidelse
elaboration	utdypning
elastic	elastisk
elastic	tøyelig
elasticity	elastisitet
elbow	albue
elder	eldre
elder, eldest	eldst
elderberry	hyllebær
elderly	aldrende
election	valg
elector, constituent	velger
electric fan, ventilator	ventilator
electric(al)	elektrisk
electrician	elektriker
electricity	elektrisitet
electrocute	henrette med elektrisitet
elegant	smakfull
element	element
element	grunnstoff
elementary	elementær
elementary school	grunnskole
elephant	elefant
elevate	heve
elevation	høyning
elevation, altitude, height	høyde
eleven	elleve
eleventh	ellevte
elicit	lokke fram
eligibility	valgbarhet
eligible	valgbar
elk	elg
elm	alm
else	annen
else	ellers
elsewhere	annensteds
elucidate	klargjøre
elude	unnvike
emaciated	utmagret
emanate	utgå
emancipate, liberate, extricate, disengage, free	frigjøre
emasculate, geld	kastrere
embalm	balsamere
embankment	voll
embark	gå ombord
embark	innlate seg
embarkation	innskipning
embarrass	gjøre flau
embarrassment	forlegenhet
embassy	ambassade
embezzle	underslå
embezzlement	underslag
embitter	forbitre
embitter	gjøre bitter
embodiment	legemliggjørelse
embody, incarnate	legemliggjøre
embroider	brodere
embroidery	broderi
emerald	smaragd
emerge	dukke opp
emergency	nødstilfelle
emetic	brekkmiddel
emigrant	utvandrer
emigrate	utvandre
emigration	utvandring
eminent	fremragende
eminent	høytstående
emission	utstråling
emit	sende ut
emotion	sinnsbevegelse
emotional	følelsesmessig
emperor	keiser
emphasis	ettertrykk
emphasize	understreke
emphatic	ettertrykkelig
empire	verdensrike
employee	arbeidstaker
employment, job, work	arbeid
empress	keiserinne
empty, inane, void	tom
enable	sette i stand til
enamel	emalje
enamel	emaljere
enamel, icing, glaze	glasur
encephalitis	hjernebetennelse
enchant, fascinate	fortrylle
enclose	inneslutte
enclose	innhenge
enclose	vedlegge
enclosure	innhengning
enclosure	vedlegg
encounter	sammenstøt
encourage	støtte
encouragement, incentive	oppmuntring
encroach, anticipate	foregripe
encroachment, fracture	brudd
encroachment, harassment	overgrep
encumber	hefte
encumbrance	heftelse
encyclopedia	konversasjonsleksikon
endangered	truet
endearment	kjærtegn
endeavour	bestrebelse
ending	avslutning
ending	endelse
ending, end, finish	slutt
endorse	påtegne
endorsement	påtegning
endow	gi gave til
endurance	utholdenhet
endure	holde ut
endure	tåle
enema	klystèr
enemy	fiende
energetic	energisk
energy	energi
enforce	fremtvinge
enforce	håndheve
enforcement	håndhevelse
enforcement	inndrivelse
engage	engasjere
engage, hire, employ	ansette
engaged	forlovet
engagement	forlovelse
engender	avle
engineer	ingeniør
engineer	tekniker
engineering	ingeniørarbeid
England	England
engrave	gravere
engrossed	oppslukt
enhancement, improvement	forbedring
enhancement, increase, gain, increment	økning
enigma	gåte
enigmatic	gåtefull
enjoy	glede seg ved
enjoy	nyte
enjoyable	hyggelig
enjoyment, gusto	nytelse
enlarge	forstørre
enlargement	forstørrelse
enlist	verve
enlist, infer, join	slutte seg til
enormous	enorm
enrage, infuriate, incense	gjøre rasende
enrapture	henrykke
enrich	berike
enrol	melde på
enrol, inscribe	skrive inn
ensign	fenrik
ensign, badge, imprint, detect	merke
ensign, banner, flag	flagg
enslave	gjøre til slave
ensue, follow, consequence	følge
ensure	sikre
ensure, guarantee	garantere
entail, involve	medføre
entangle	vikle inn i
entanglement	sammenfiltring
enter	bokføre
enter	gå inn
enter	komme inn
enteritis	tarmbetennelse
enterotomy	tarmbrokk
enterprise	foretagende
enterprise	foretaksomhet
enterprising	foretaksom
entertain	more
entertain	underholde
entertain, feast	beverte
entertainment	forlystelse
entertainment	representasjon
entertainment	underholdning
enthusiasm	entusiasme
enthusiasm, exuberance	begeistring
enthusiast	entusiast
enthusiastic	begeistret
enthusiastic	entusiastisk
entice	forlede
entice, lure	lokke
entire, full	hel
entitle	berettige
entrance, portal	inngang
entree	hovedrett
entrust, confide	betro
entry	inntreden
enumerate	oppsummere
envelop	innhylle
envelope	konvolutt
enviable	misunnelsesverdig
envious	misunnelig
environment	omgivelse
environment	omgivelser
environmental, environment	miljø
environmentalist	miljøforkjemper
envisage, imagine	forestille seg
envoy, delegate	utsending
envy	misunnelse
Eoropean	Europeer
Eoropean	Europeisk
epidemic	epidemi
epidemic	epidemisk
epidemic	farsott
episcopalian	biskoppelig
episcopalian	episkopal
episcopate	bispeembete
epitaph	gravskrift
equal	jevnbyrdig
equal	jevnbyrdige
equal	like
equalize	utjevne
equanimity	sinnslikevekt
equation	ligning
equation, equality	likestilling
equator	ekvator
equestrian	rytter
equilibrium	likevekt
equinox	jevndøgn
equip	utruste
equipment	utrustning
equipment, gear, fittings, kit	utstyr
equivalence	likeverd
equivalent	tilsvarende
equivocal	tvetydig
era	tidsalder
era	æra
eradicate, exterminate, extinguish	utrydde
erase, delete	stryke ut
eraser	raderkniv
eraser	viskelær
erect	oppføre
erect	oppreist
erection	ereksjon
erection	oppførelse
ermine	hermelin
ermine	røyskatt
erode	erodere
erode	tære bort
err, lapse	feile
errand	ærend
errandboy	visergutt
erratic	uberegnelig
erratic	ujevn
erroneous	feilaktig
erudition, learning	lærdom
erupt	bryte fram
erupt	være i utbrudd
escalate	trappe opp
escalation	opptrapping
escalator	rulletrapp
escalope	schnitzel
escapade	sidesprang
escape	rømning
escape	unnslippe
escort	eskorte
escort, accompany, attend	ledsage
especial, particular, special	spesiell
especially	spesielt
especially, especial	særlig
espionage	spionasje
essay	essay
essay	stil
essential	vesentlig
essential, imperative	absolutt nødvendig
establish	etablere
establish, found, institute	opprette
established	etablert
established church	statskirke
establishment	etablering
establishment	etablissement
estate	gods
estate, possession, property	eiendom
estate-agent	eiendomsmegler
esteem, estimation	aktelse
estimate	beregne
estimate	overslag
estimate	taksere
estimation, evaluation, appraisal, estimate	vurdering
estrange	fremmedgjøre
estuary	elvemunning
etch	etse
etching	etsning
etching	radering
eternal	evig
eternalize	forevige
eternity	evighet
ethics	etikk
ethnic	etnisk
eulogy	lovtale
Europe	Europa
evacuate	evakuere
evacuate	tømme
evacuate, abscond	rømme
evacuation	evakuering
evade	lure seg unna
evade, avoid, escape	unngå
evaluate, appreciate	verdsette
evaluation	verdsettelse
evaporate	fordampe
evaporation	fordampning
evasive, elusive	unnvikende
eve	aften
even	selv om
even	til og med
even, level	jevn
even, like, equal, corpse	lik
evening	kveld
evening meal, supper	kveldsmat
event	begivenhet
event	øvelse
eventful	begivenhetsrik
eventual, finally, final, at last, definitive	endelig
eventuality	eventualitet
ever	noensinne
ever	stadig
everlasting	evigvarende
evermore	for alltid
every	enhver
everyday	hverdagslig
everything, all, the lot	alt
everywhere	overalt
evict	kaste ut
eviction	utkastelse
evidence	bevis
evidence	vitneutsagn
evident	innlysende
evident, explicit, distinct, apparent	tydelig
evidently	tydeligvis
evidently	øyensynlig
evil	ond
evil	onde
evocative	stemningsfull
evoke, reveal, develop	fremkalle
ex, from	fra
exacting	krevende
exactly, exact	nøyaktig
exaggerate	overdrive
exaggeration	overdrivelse
exalt	lovprise
exalt	opphøye
exaltation	opphøyelse
exaltation	opprømthet
exam	opptaksprøve
exam-fee	inngangspenger
examination	eksaminasjon
examination, inquiry, enquiry	undersøkelse
examine	eksaminere
excavate	grave ut
excavation	utgravning
exceed	overskride
excel	utmerke seg
excel, exceed	overgå
excellence	fortreffelighet
excellent	fortreffelig
excellent, fine	utmerket
except	unnta
except	untatt
except	uten
exception	innsigelse
exception	unntagelse
exceptional, extraordinary	usedvanlig
excess	overmål
excess	overskridelse
exchange	valutaveksling
exchange, interchange	utveksling
exchange, loot	bytte
exchangerate	vekslingskurs
excise	fjerne
exciseduty	forbrukeravgift
excitable	pirrelig
excite	opphisse
excitement	opphisselse
excitement	spenning
exclaim	utbryte
exclamation	utrop
exclude	utelukke
exclusion	utelukkelse
exclusive	eksklusiv
excrete	skille ut
excrete	utsondre
excruciating, insufferable	ulidelig
excursion, sightseeing trip, outing, excursion	utflukt
excusable	unnskyldelig
excuse	unnskyldning
excuse me	unnskyld
excuse, exempt	frita
excuse, extenuate	unnskylde
excusively	utelukkende
execute	effektuere
execute	fullbyrde
execute	henrette
execution	effektuering
execution	henrettelse
execution	utførelse
executioner, hangman	bøddel
executive	utførende
executive	utøvende
executive, leader, head, director	leder
exemplary	mønstergyldig
exemplify	belyse ved eksempler
exemption	fritagelse
exercise	mosjon
exercise	mosjonere
exercise	utøvelse
exert	anstrenge
exert	bruke
exert	øve
exhaust	eksos
exhaust	utmatte
exhaustion	rovdrift
exhaustion	utmattelse
exhaustive	grundig
exhaustive	uttømmende
exhaustpipe	eksosrør
exhibit	utstille
exhibit	utstillingsgjenstand
exhibition	fremvisning
exhibition, grant	stipend
exhilarate	live opp
exhilarated	opprømt
exigency	tvingende nødvendighet
exigent	presserende
exile	landflyktighet
exile, expatriate	eksil
exist	eksistere
existence	tilværelse
existence, being	eksistens
existing	eksisterende
existing	foreliggende
exorbitant	ublu
exorbitant, incongruous	urimelig
expand	utbre
expand, extend	utvide
expansive	ekspansiv
expansive	meddelsom
expansive	utvidbar
expatriate	landsforvise
expatriation, exile	landsforvisning
expect	forvente
expect, assume, figure	anta
expectant, hopeful	forventningsfull
expectorant	slimløsende
expectorate	hoste opp
expediency	hensiktsmessighet
expedient	hensiktsmessig
expedient	utvei
expedite, quicken	påskynde
expedition	ekspedisjon
expeditious	ekspeditt
expel	utvise
expencive, animal, costly, pricey, dear, expensive	dyr
expenditure	forbruk
expenditure	utgifter
expenses	omkostning
experience	erfaring
experienced	erfaren
experiment	eksperiment
expert	ekspert
expert	fagmann
expert	sakkyndig
expiration	utløp
expiration	utånding
expire	utånde
explain, define	forklare
explanation	forklaring
explicit, expressly	uttrykkelig
explode	eksplodere
exploit	bedrift
exploit	dåd
exploit	utnytte
exploitation	nyttiggjøring
exploitation	utnyttelse
exploration	utforskning
exploratory drilling	prøveboring
explore	utforske
explorer	oppdagelsesreisende
explorer	utforsker
explosion	eksplosjon
explosive	eksplosiv
explosive	sprengstoff
exponent	eksponent
exponent	talsmann
export	eksportere
export	utførsel
exportation, export	eksport
exports	utførselsvarer
expose	stille ut
expose, delay, adjourn	utsette
exposure	eksponering
exposure	utsetting
express	ekspress
express	expresstog
express	ilbud
expression	uttrykk
expressive	uttrykksfull
expulsion	fordrivelse
expulsion	utvisning
exquisite	utsøkt
extencionflex, extension lead	skjøteledning
extensible	strekkbar
extension	forlengelse
extension, extension, expansion	utvidelse
extensive, comprehensive	omfattende
extensive, large	utstrakt
extent	omfang
extent, extension	utstrekning
extenuate	mildne
extenuated circumstances	formildende omstendigheter
exterior	utside
exterminate	tilintetgjøre
extermination	utryddelse
external	utenriks
external, exterior	utvendig
external, exterior	ytre
extinct	sloknet
extinct	utdødd
extinction	slokking
extinction	utslettelse
extinguish	slokke
extinguisher	slokkingsapparat
extort, crush	presse
extortion	utpressing
extract	ekstrakt
extract	trekke ut
extractable	utvinnbar
extraction	avstamning
extraction	uttrekking
extraction	utvinning
extradite	utlevere
extradition	utlevering
extraordinary, queer	merkelig
extravagance	ekstravaganse
extravagance	urimelighet
extravagance	ødselhet
extravagant	ekstravagant
extravagant	ødsel
extravasation	bloduttredelse
extreme	drastisk
extreme	ekstrem
extreme	ekstreme
extreme	ytterlighet
extremely	høyst
extremely, extreme, extreme	ytterst
extremity	ekstremitet
extremity	ytterpunkt
extrication, liberation	frigjøring
exuberance	frodighet
exuberance, abundance	overflod
exuberant, lush	frodig
exult	juble
exultation	jubel
eye	øye
eyeball	øyeeple
eyebrow	øyenbryn
eyelash	øyenvippe
eyelid	øyelokk
eyesocket	øyenhule
eyewitness	øyenvitne
fable	dikte
fable	fabel
fable	fable
fabric	vevning
fabric, dope	stoff
fabricate	dikte opp
fabrication	oppspinn
fabulous	fabelaktig
face	ansikt
face	overflate
face	stå overfor
face	tallskive
facelift	ansiktsløftning
facepack	ansiktsmaske
facetious, jocular	spøkefull
facetissue	ansiktsserviett
facial	ansikts-
facilities	hjelpemidler
facilities	muligheter
fact	faktum
fact	kjennsgjerning
faction	fraksjon
faction, group	gruppe
factious	fraksjonsdannende
factor	faktor
factory	fabrikk
factual	saklig
factual, actual	faktisk
faculty	fakultet
faculty, capability	evne
fad	kjepphest
fad, quirk, impulse	innfall
fade	dø hen
fade	falme
fade	toning
fade	visne
fade, quell, curb, dim	dempe
fag, labour	slit
fag, labour	slite
faggot	risknippe
fail	forsømme
fail	slå feil
fail	stryke
fail, forsake, falter	svikte
failure	falitt
failure	svikt
faint	besvime
faint, feeble, frail, dim	svak
fairly	nokså
fairway	skipsled
fairy	fe
fairytale, adventure	eventyr
faith	tillit
faith, belief	tro
faithless	troløs
faker	forfalsker
falcon	falk
fall	fall
fall	falle
fallacy	feilslutning
Fallobian tube	eggleder
fallout	konsekvenser
fallout	nedfall
fallow	brakkmark
falls, waterfall	foss
false, bastard, insincere	uekte
falsehood, lie	løgn
falter, hesitate, linger	nøle
faltering	nølende
faltering	vaklende
fame	berømmelse
fame	ry
familiar	velkjent
familiarity, intimacy	fortrolighet
familiarize	gjøre seg kjent med
family	familie
famine	hungersnød
famished	skrubbsulten
famous	berømt
fan	beundrer
fan	kornrenser
fan	vifte
fanatic	fanatisk
fanaticism	fanatisme
fanbelt	viftereim
fancy	mønstret
fancy	pyntet
fantastic	fantastisk
far	langt borte
far, remote, distant, far	fjern
far-fetched	søkt
far-fetched, improbable	usannsynlig
fare	billettpris
fare	takst
faremeter	taksameter
farestage	takstsone
farewell	farvell
farewell, dismissal	avskjed
farm, ranch, property, estate	gård
farmer	gårdbruker
farming	jordbruk
farmyard, yard	gårdsplass
farther	fjernere
farther	lengre
farthest	fjernest
farthest	lengst
fashion	mote
fashion	måte
fashionable	moderne
fashionable, elegant	elegant
fast train	hurtigtog
fast, brisk, expeditious, hurried, hasty	rask
fast, Lent	faste
fasten	lukke
fastener, lock, interlock	lås
fastidious, fussy	kresen
fastness	hurtighet
fat	fet
fatal	dødbringende
fatal, fateful	skjebnesvanger
fatality	skjebnebestemt
fatality, accident, disaster	ulykke
fatally	skjebnesvangert
father	far
father-in-law	svigerfar
fatherhood	farskap
fatherless	farløs
fatherly	faderlig
fathom	favn
fathom, capelin	lodde
fatigue	tretthet
fattiness	fettholdighet
faucet	tappekran
fault, defect, flaw, error, mistake, lapse	feil
fault, guilt	skyld
faultless, flawless	feilfri
favour	begunstige
favour	tjeneste
favourable	gunstig
favoured	begunstiget
favourite	favoritt
favourite	yndling
fax	fakse
faxmachine	faks
fear	frykte
fear	være redd for
fearful	engstelig
feasibility	gjennomførlighet
feasibility	mulighet
feasible	gjennomførlig
feasible	mulig
feast	fest
feast	pryd
feat	prestasjon
feather	fjær
feathery	fjærkledd
feathery	fjærlett
feature	attraksjon
feature	innslag
feature, draught	trekk
featureless	uten særpreg
febrifuge	febernedsettende middel
February	februar
fecund, fertile, fruitful	fruktbar
fed up	lei
federal	forbunds-
federal	føderal
federate	gå sammen i forbund
federation	føderasjon
fee	gebyr
fee	honorar
feed	mate
feed, eat	spise
feed, line	fôre
feed, meal	måltid
feedback	tilbakemelding
feeder	en som mater
feel	føle
feel	kjenne
feeler	føler
feeler, antenna	følehorn
feeling, emotion	følelse
feet	føtter
feign	late som
felicitate	lykkønske
felicitation	lykkønsning
fellow	kamerat
fellow	medlem
fellow	stipendiat
fellowship	fellesskap
fellowship	kameratskap
felon	forbryter
felony, crime	forbrytelse
felt	filt
female	hunn
feminine, female	kvinnelig
fence	fekte
fence	gjerde
fence	hele
fence, handler	heler
fencer	fekter
fencing	fekting
fend off	avverge
fend off	parere
fender	bilskjerm
fender	fender
fender, bumper, buffer	støtfanger
fennel	fennikel
ferment	gjære
ferment	gjæringsmiddel
fermentation	gjæring
fern	bregne
ferocious	glupsk
ferocious, frantic	vill
ferret	fritte
ferret	lider
ferret	oppspore
ferry, ferry	ferje
fertility	fruktbarhet
fertilization	befruktning
fertilize	befrukte
fertilize	gjødsle
fertilizer	kunstgjødsel
fervour	inderlighet
festival	festspill
festival, feast	høytid
festive	festlig
festivity	festlighet
festoon	girlander
fetter	fotlenke
feud	feide
feud	strid
feudal	føydal
feudalism	føydalisme
feudalism	lensvesen
fever	feber
feverish	febrilsk
fiancèe	forlovede
fib	liten løgn
fibre	fiber
fibre	støpning
fickle	ustadig
fiction	diktning
fiction	oppdiktning
fiction	skjønnlitteratur
fictitious	oppdiktet
fictive, fictitious	fiktiv
fiddle	fele
fidelity	troskap
fidgety	være urolig
field	felt
field	jorde
fiend, devil	djevel
fierce	sint
fiery	flammende
fiery	fyrig
fiery, impetuous	heftig
fifteen	femten
fifth	femte
fiftieth	femtiende
fifty	femti
fig	fiken
fig	fikentre
fight	kamp
fight	slåss
fight, giant	kjempe
fighterjet	jagerfly
figure	figurere
figure	framstille
figure	tall
figure, form	skikkelse
file	arkiv
file	fil
file	kartotek
filial	datterlig
filial	sønnlig
filigree	filigran
fill	fylle
fill	plombere
fillet	filèt
filling	plombe
filling, fill	fyll
filly	hoppeføll
film	filme
film	hinne
filter	filter
filter	filtrere
filth	smuss
filth, dirt, grime, shit	skitt
final	sist
finale, final	finale
finalize	sluttføre
finally	tilslutt
finals	avgangseksamen
finance	finans
finance, fund	finansiere
finances	finanser
financial	finans-
find, fin	finne
finder	søker
finding	kjennelse
finding, find	funn
findings	resultater
fine	bot
fine	bøtele
fine	mulkt
fine, beautiful	pen
fineness	finhet
finger	finger
finger	fingre med
finger	ta på
fingerprint	fingeravtrykk
finish	avslutte
finish	finpuss
finish	oppløp
finish	sluttstrøk
finished	fullbrakt
finished, done	ferdig
fir	gran
fir, pine, pine tree	furu
fire	brann
fire	bål
fire	fyre av
fire	ild
fire	lidenskap
fire	varme
fire, kick	sparke
fire-extinguisher	brannslukkings-apparat
firing	avfyring
firing	skyting
firm	fast
firm	firma
firm	standhaftig
firmness	fasthet
first	første
firstly	for det første
fish	fisk
fish	fiske
fish hook	fiskekrok
fisheries	fiskeri
fisherman	fisker
fishfarm	fiskeoppdretter
fishfarm	havbruk
fishing rod	fiskestang
fishmonger	fiskehandler
fission	spalting
fist	knyttneve
fist	neve
fit	skikket
fitness	egenhet
fitness	kondisjon
fitted	tilpasset
fitter	montør
fitting	montering
fitting, appropriate, eligible, fit, convenient	passende
fittings	armatur
five	fem
fix	fiksere
fix	ordne
fix, fasten	feste
fixation	binding
fixation	fiksering
fixative	bindemiddel
fixed	fastsatt
fixed	festet
fizz	bruse
fizzy	musserende
fjord, loch, firth, inlet	fjord
flabbergast	forbløffende
flabby	pløsete
flagpole	flaggstang
flagrant	åpenbar
flagstone, incline, lean	helle
flair	teft
flair, elegance	eleganse
flair, nose, nose	nese
flak	antiluftskyts
flake	flak
flake	fnugg
flake off	flasse
flake off	skalle av
flan	fruktterte
flank	flanke
flannel	flanell
flannels	flanellsbukser
flap	blafring
flap	klaff
flare	bluss
flare	blusse
flare	flakke
flash	blink
flash, gleam, glint, glimpse	glimt
flash, glint	blinke
flashbulb	blitzpære
flasher	blitz
flasher, direction-indicator	blinklys
flashlight, electric torch	lommelykt
flashy	prangende
flashy, gaudy	glorete
flask	kolbe
flat	leilighet
flat	punktering
flat, delete	slette
flat, flat, even, smooth	flat
flat, level	flate
flat-footed	plattfot
flat-iron	strykejern
flatly	kategorisk
flatten	gjøre flat
flatter	smigre
flatterer	smigrer
flattery	smiger
flavour	aroma
flaw, lack, defect, deficiency, absence	mangel
flax, linen	lin
flea	loppe
flee, fly	flykte
fleece, flay	flå
fleece, hide	skinn
fleecy	ullen
fleet	vognpark
flex	ledning
flexibility	bøyelighet
flexibility	fleksibilitet
flexible	bøyelig
flexible	fleksibel
flicker	flimre
flicker, flap	blafre
flight	flygning
flight	flytur
flight	svev
flight, escape	flukt
flimsy	spinkel
flinch	vike tilbake
fling	hive
fling	slenge
fling, haul	kast
flint	flint
flip	knips
flip	knipse
flippant	fleipete
flippant	rappmunnet
flirt	flørte
flirtation	flørt
flit	pile
flit	smette
float	dupp
float	flottør
float, fleet	flåte
float, flow	flyte
flock	flokkes
flock	ulldott
flock, herd	flokk
floe	isflak
flog, lash, flogging	piske
flogging	pisking
flood	flom
flood, deluge	oversvømmelse
flood-tide	høyvann
floodlight	flomlys
floodlit	flombelyst
floor	golv
floor, storey, story	etasje
flop	deise
flop, failure	fiasko
flop, hit	slå
floppydisk, disc	diskett
florid	overlesset
florid	rødmusset
florist	blomsterhandler
floss	dun
flotation	stiftelse
flounced	med kapper
flounder	flyndre
flounder, flop	bakse
flourish	fanfare
flourish	florere
flourish	snirkel
flourish	trives
flourishing	blomstrende
flow, current, flush, high tide	strøm
flow, flood-tide	flo
flower	blomstre
flower, bloom	blomst
flowering	blomstring
fluctuate	svinge
fluctuate	variere
fluctuation	svingning
fluency	taleferdighet
fluent, liquid, fluid	flytende
fluff	lo
fluffy	dunbløt
fluid, liquid, liquor	væske
flunk	gi strykkarakter
fluorescent tube	lysrør
fluoridation	fluorisering
fluoride	fluor
flurried	forfjamset
flurry	kave
flurry, gust	vindstøt
flush	spyle
flustered	oppskjørtet
flute	fløyte
flutter	flagre
flutter	flagring
flutter	gjøre urolig 
flutter	vibrering
fly	buksesmekk
flyer, flier	flyger
foal	følle
foamy	skummende
focus	brennpunkt
focus	fokus
focus	fokusere
fodder, lining, forage	fôr
foetus	foster
fog, haze	dis
fog, mist	skodde
fog, mist	tåke
foggy	diset
foggy	tåket
foggy, dim	uklar
foil	florett
foil	folie
foil, baffle, frustrate	forpurre
fold	brette
fold	fold
fold	folde
fold up	legge sammen
folder	falsemaskin
folder	folder
folder	mappe
folding chair	klappstol
foliage	løvverk
folk	mennesker
folk, people	folk
follow	etterfølge
follow up	oppfølging
follower	tilhenger
following	følgende
folly	dårskap
food	mat
fool	bedra
fool	tøyse
foolproof	idiotsikker
football, soccer	fotball
footing, foothold	fotfeste
footpath	gangsti
footprint	fotspor
footstep	fottrinn
for	for
for instance	for eksempel
for, off	av
forbear	unnlate
forbearance, indulgence	overbærenhet
forbid	forby
forbidding	avskrekkende
forbidding	frastøtende
force	forsere
force	makt
force	sprenge
force	tvinge
force, energy, juice	kraft
forced, enforced	påtvungen
forcible	tvangs-
forcible, hearty, ablebodied	kraftig
ford	vade over
ford	vadested
fore	for-
forearm	underarm
forebode	varsle
forecast	forutsi
forecast	forutsigelse
forecastle	ruff
forefront	forreste linje
foreground	forgrunn
forehead	panne
foreignworker	fremmedarbeider
foremost	fremst
foremost, fore, forward	forrest
foresee, anticipate	forutse
forestation	skogplantning
forester	forstmann
forestmanagement	skogforvaltning
forestry	skogindustri
forestry	skogvesen
forfeit	forbrutt
forfeit	forspille
forfeit	forspilt
forfeit, gage	pant
forget	glemme
forgetful	glemsom
forgive	tilgi
forgiveness	tilgivelse
fork	dele seg
fork	gaffel
fork	greip
fork	veiskille
form	danne
form	form
form	forme
form	skjema
form	skoleklasse
formal	formell
formality	formalitet
format	formatere
formation	danning
formation	formasjon
formative	grunnleggende
former, late, ex	forhenværende
formic	maur-
formicide	maurmiddel
formidable	fryktinngytende
formula	formel
formula	oppskrift
formulate	formulere
forsake	oppgi
forth	fram
forthcoming	forekommende
forthright	liketil
forthright	åpenhjertlig
fortieth	førtiende
fortify	befeste
fortitude	sjelsstyrke
fortnight	fjorten dager
fortress	festning
fortunately, luckily	heldigvis
fortune	formue
fortuneteller	spåkone
fortuneteller	spåmann
forty	førti
forward	fremmelig
forward	fremover
forward	videresende
forwarding	foresendelse
forwarding agent	speditør
foster	fostre
foster	ha i pleie
foul	vulgær
foul, dishonest	uærlig
found	grunnlegge
found	støpe
foundation	fundament
foundation	grunnleggelse
foundation	grunnmur
foundation, endowment	legat
foundry	støperi
fountain	fontène
fountain pen	fyllepenn
fourfold	firedobbelt
fourteen	fjorten
fourth	fjærde
fox	rev
fraction	brøkdel
fractional	brøk-
fractional, insignificant	ubetydelig
fractured	brukket
fragile, frail	skrøpelig
fragment	bruddstykke
fragrance	duft
fragrance	vellukt
fragrant	duftende
fragrant	velluktende
frailty	svakhet
frame	innramme
frame	karm
frame, fabric	struktur
frame, hit	ramme
framework	rammeverk
France	Frankrike
franchise	rettighet
franchise	stemmerett
frankly	åpent
frantic	panisk
fraternal	broderlig
fraternity	brorskap
fraud	svindler
fraud, con	svindel
fraudulent, deceitful	svikefull
fraudulent, false	falsk
fraught, intent	anspent
frayed	frynsete
freak	original
freakish	uvanlig
freckle	fregne
free	befri
free	utvungen
freemason	frimurer
freeway	motorvei
freeze	fryse
freeze	stivne
freezer	fryser
freight	frakte
freighter	lastebåt
frenzy	vanvidd
frenzy, fury	raseri
frequency	frekvens
frequency, incidence	hyppighet
frequent	frekventere
frequent	hyppig
fresh	fersk
freshen	friske på
freshen up	stelle seg
freshness	friskhet
freshwater	ferskvann
fret	slite på
fret, chafe, irritate, gall, exasperate	irritere
fret, exasperate	ergre
friar	tiggermunk
friction	friksjon
friction	gnidning
Friday	fredag
fridge	kjøleskap
friend	venninne
friend, friend	venn
friendly	vennskapelig
friendship	vennskap
frieze	frise
frieze	vadmel
fringe	frynse
fringe	pannelugg
fringe	utkant
fringe benefits	frynsegoder
frisky	leken
frisky	spretten
frivolity	fjollethet
frivolity	lettsindighet
frivolous	betydningsløs
frivolous	fjollete
frock, robe, dress	kjole
frog	frosk
frogfish	breiflabb
frogman	froskemann
frolic	boltre seg
frolic	munterhet
from	på grunnlag av
from	ut fra
front	fasade
front	front
front door	inngangsdør
front, frontpage, battlefront, frontage	forside
frontwing	forskjerm
frost	frost
frost	rim
frostbitten	frostskadet
frosted	dekket av rim
frosted	mattslipt
frosty	is-
frosty, bleak, cold, chilly	kald
froth	fråde
froth, foam, lather	skum
froth, lather, foam, fizz	skumme
frown	rynke
frown on	misbillige
frozen	frosset
frozen	sperret
frozen	tilfrosset
frugal	nøysom
frugal	sparsommelig
fruit	frukt
fruitless	nytteløs
frustrate	frustrere
frustration	forpurring
fry	yngel
frying pan	stekepanne
fuel	brensel
fuel	drivstoff
fuel gauge	bensinmåler
fugitive	flyktende
fugitive	flyktig
fugitive, displaced person	flyktning
fulfil	innfri
fulfil	oppfylle
fulfilment	oppfullelse
full	utførlig
full, entirely	fullstendig
fullness	fylde
fully	fullt ut
fumble	rote
fumble, grope	famle
fume	damp
fume	dunste
fume	rase
fume	ryke
fun	fornøyelse
function	fungere
function	funksjon
function	oppgave
functional	funksjonell
functional	funksjons-
fund	fond
fund	kapital
fundamental	fundamental
fungicide	soppdreper
funnel	skorstein
funnel	trakt
funny, jolly, humorous	morsom
fur	tungebelegg
fur piece, fur, fur coat	pels
furcoat	pelskåpe
furlined	skinnforet
furnace, oven, stove, kiln	ovn
furrier	buntmaker
furrow	lage furer i
furrow, groove	fure
furs	pelsverk
further	lenger
further	mer
further	ytterligere
furthermore	dessuten
furtive	hemmelig
furtive	hemmelighetsfull
fury	furie
fuse	lunte
fuse	sikring
fuse box	sikringsskap
fusible	lettsmeltelig
fusion	fusjon
fusion	sammensmelting
fuss	mase
fuss	oppstyr
fussy	masete
futile	forgjeves
futile	intetsigende
futility	formålsløshet
future	fremtid
future	fremtidig
fuzzy	flokete
fuzzy	krusete
gable	gavl
gad about	farte omkring
gadfly	brems
gadfly, horsefly	klegg
gadget, contrivance, device	innretning
gadget, cope, accomplish	greie
gag	knebel
gag	kneble
gag	vits
gaiety	lystighet
gain	vinning
gain, benefit, profit	gagn
gain, earn	tjene
gait	gangart
gaiter	gamasje
gale	kuling
gall	bitterhet
gall	galle
gall	gnagsår
galled	hudløs
gallery	galleri
gallery	stoll
galley	bysse
gallop	galopp
gallop	galoppere
gallows	galge
gallstone	gallestein
galore	i massevis
galosh	kalosje
gamble, act	spille
gambler	spiller
game, gamble	spill
gamekeeper	skogvokter
gamelicence	jaktlisens
gander	gasse
gang	arbeidslag
gang	bande
gang	gjeng
gangrene	koldbrann
gangrenous	angrepet av koldbrann
gangway	fallrep
gangway, debarkation	landgang
gaol, jail, prison, gaol	fengsel
gap, aperture	åpning
gap, hole	hull
gape	gape
gape	måpe
garage	bilverksted
garage	garasje
garage, fillingstation	bensinstasjon
garbage	avfall
garbage, litter	søppel
garden	hage
garden	have
gardener	gartner
gardening	hagearbeid
gardening, horticulture	hagebruk
gargle	gurglevann
garland	bekranse
garland	krans
garlic	hvitløk
garment	plagg
garnet	granat
garnish	garnere
garnish	garnering
garnish	pynte
garret	kvisteværelse
garrison	garnison
garrulous	snakkesalig
garter	sokkeholder
garter	strømpebånd
gas	gass
gash	flenge
gash	gapende sår
gasket	pakning
gasoline, gasolene, petrol	bensin
gasp	gispe
gastric	mage-
gastrulcer	magesår
gate	grind
gate	port
gather	plukke
gathering	sammenkomst
gaudy, glaring	grell
gauge	måler
gauge	sporvidde
gaunt	radmager
gauntlet	kjørehanske
gauntlet	stridshanske
gauze	gasbind
gay	homoseksuell
gaze, goggle	stirre
gazette	lysingsblad
gear	gir
gear, appliance, implement	redskap
gear-case, gear-box	girkasse
gearlever	girstang
gelding	vallak
gem	edelsten
gender, sex	kjønn
geneologist	slektsforsker
geneology	slektsforskning
geneology	slektshistorie
general	general
general	generell
generally	vanligvis
generate	frembringe
generation	generasjon
generation	slektsledd
generosity	gavmildhet
generosity	høysinn
generous	rundhåndet
genial, friendly, kind	vennlig
genitals	kjønnsorganer
genius	geni
genius	skytsånd
gentle, soft, sweet, tender	søt
gentry	fornemme folk
gentry	lavadelen
geographer	geograf
geography	geografi
geologist	geolog
geology	geologi
germ	bakterie
germ	spire
germcarrier	smittebærer
germicide	bakteriedreper
gesture	gestikulere
gesture	gestus
get	bli
get, fetch	hente
get, have, few	få
ghastly	grufull
ghastly	likblek
gherkin	sylteagurk
ghost	spøkelse
ghost	ånd
giant	rise
gibberish	uforståelig snakk
gibberish	vrøvl
gibe	spott
giddy	ør
giddy, dizzy	svimmel
gift	anlegg
gift, endowment, present, donation	gave
gifted	begavet
gigantic	gigantisk
gigantic, giant	kjempemessig
giggle	fnise
gild	forgylle
gill	gjelle
gilt	forgylling
gilt	forgylt
gimmick, knack	knep
gin	aquavit
ginger	ingefær
ginger	rødbrun
gingerale	ingefærøl
gingerbread	honningkake
girder	bærebjelke
girdle	belte
girdle	hofteholder
girdle	omgi
girl	jente
girl	pike
girlish	jenteaktig
gist	hovedinnhold
give, allow, yield, inflict, hand, bestow	gi
glacier	isbre
glade	lysning
gladly	gjerne
gladly	med glede
gladness, zest, joy, enjoyment, gratify, delight	glede
glamour, enchantment	fortryllelse
glamourous	fortryllende
gland	kjertel
glare	skarpt lys
glare at	glo olmt på
glare, dazzle	blende
glaring	blendende
glass	glass
glasses, spectacles	briller
glazed	glassaktig
glazier	glassmester
glazing	glassarbeid
gleam	glimte
gleam, glare	skinne
glee	fryd
glen	fjelldal
glen	skar
glib	tungerapp
glide	gli
glide	glidning
glider	glider
glimpse	skimte
glisten	glinse
glisten, glint, glitter	glitre
glitter	funkle
glitter	glitring
globe	globus
gloom	halvmørke
gloom	tungsinn
gloomy, glum	dyster
glorification	forherligelse
glorify	forherlige
glorious, illustrious	strålende
glory	salighet
glory, glamour, gloss, lustre	glans
glossary	ordliste
glossy	blank
glove, mitten	hanske
glue	lim
glutton	fråtser
glutton	jerv
gluttonous, greedy	grådig
gluttony	forslukenhet
gnarled	knudrete
gnat, mosquito	mygg
gnaw	nage
gnaw, chafe, gall, fret	gnage
gnome, dwarf	dverg
go	gå
go for a walk, stroll	spasere
goad	piggstav
goalkeeper	målvakt
goat	geit
goatee	fippskjegg
gobble, gulp, devour	sluke
goblet	beger
goblet	pokal
God	Gud
godchild	gudbarn
goddess	gudinne
godfather	gudfar
godlike, divine	guddommelig
godly, devout	from
goggles	beskyttelsesbriller
gold	gull
golden	gylden
golf	golf
golfclub	golfklubb
golfclub	golfkølle
golfcourse	golfbane
golfer	golfspiller
gong	gongong
good	behage
good afternoon	god middag
good day	goddag
Good Friday	langfredag
good morning	god morgen
good night	god natt
good, able, capable, clever	dyktig
good, clever	flink
good, kind	snill
good-natured	godmodig
goodbye, so long, bye	på gjensyn
goodness	godhet
goods	varer
goodwill	kundekrets
goodwill, benevolence, favour	velvilje
goof	fjols
goof	tabbe
goose	gås
gooseberry	stikkelsbær
gooseflesh	gåsehud
gorge	fråtse
gorge, gulch	fjellkløft
gorgeous	praktfull
gory	blodig
gospel	evangelium
gossip	sladder
gossip	sladre
gout	gikt
gouty	giktisk
govern	regjere
governess	guvernante
government, government	regjering
governor	guvernør
gown	lang kjole
gown, cape	kappe
grab	snappe
grace	bordbønn
grace	hedre
grace	ynde
grace, adorn	pryde
graceful	grasiøs
gracious	elskverdig
gracious	nådig
gradation	nyanse
grade	gradere
grade	karakter
grade	trinn
grade, class	klasse
gradient	stigningsgrad
gradual	gradvis
graduate	kandidat
graft	pode
graft	podning
grain	korn
grain	korne seg
grain	tekstur
grammar	grammatikk
grand-father	bestefar
grand-mother	bestemor
grandchild	barnebarn
grandstand	sitte-tribune
grange	bondegård
grant	bevilge
grant	bevilgning
granulated	kornete
grape	drue
grapefruit	grapefrukt
graph	diagram
graph paper	rutepapir
graphic	grafisk
grasp, hold, grip	grep
grass	gress
grasshopper	gresshoppe
grasswidow	gressenke
grasswidower	gressenkemann
grate	raspe
grate	rive
grate	skurre
grateful	takknemlig
grater	rivjern
gratification	tilfredstillelse
gratify	tilfredstille
gratitude	takknemlighet
gratuitous, free	gratis
grave	betydningsfull
grave, tomb	grav
gravelled	gruslagt
graveyard, cemetery	kirkegård
gravitation	tyngdekraft
gravity	alvor
gravity	tyngde
gravy	kjøttsaft
graze	beite
graze	få skrubbsår
grease, fat	fett
greasy	fettete
greatly, highly	i høy grad
greatness	storhet
greed	grådighet
green	grønn
green	grøntareale
greenhouse	drivhus
greet	hilse
greeting	hilsen
gregarious	selskapelig
grey, gray	grå
greyhound	mynde
gridiron	grillrist
grief, sorrow, sadness	sorg
grievance	klagemål
grieve	sørge
grieve	volde sorg
grievous, earnest, grave	alvorlig
grill	grille
grill, grate	rist
grim	bister
grime	sot
grimy	sotete
grimy, unclean, foul, grubby, filthy, soiled	skitten
grin	glise
grin	smile bredt
grind	male
grind	maling
grind	slipe
grinder	jeksel
grindstone	slipestein
gripping, compelling	fengslende
grisly, lurid, ghastly, grim	uhyggelig
gristle	brusk
grit	sandkorn
grit	strø
grit, gravel	grus
gritty	sandete
grizzly	grålig
grizzly	gråsprengt
groan	knake
groan	stønn
groan	stønne
groceries	dagligvarer
grog	brennevin og vann
grog	grogg
groggy	omtåket
groin	lyske
groom	stallkar
groove	spor
grope	føle seg fram
gross	brutto
gross	gross
gross	plump
gross, bold, thick, fat, corpulent	tykk
ground	bunn
ground	grunnstøte
ground	terreng
ground	årsak
groundfloor	første etasje
group	gruppere
grouse	rype
grove	lund
grove	skogholt
grovel	krype for
grow	vokse
growl	knurre
growl	knurring
growler	brumlebasse
grub, dig	grave
grudge, envy	misunne
gruel	velling
gruesome	gyselig
gruff, coarse, gross	grov
grumble	beklage seg
grumble	rumle
grumpy, fretful, grouchy, querulous	gretten
grunt	grynt
grunt	grynte
guarantee	garanti
guarantee	kausjonist
guarantee, bail	kausjon
guard	bevoktning
guard	garde
guard	konduktør
guard	vakt
guard	vokte
guardian	beskytter
guardian	formynder
guess	gjetning
guess	gjette
guest	gjest
guidance	veiledning
guild	laug
guile	list
guile	svik
guise, disguise	forkledning
guitar	gitar
gulf	havbukt
gulf, abyss	avgrunn
gullet	spiserør
gullible	lettroende
gully	renne
gully, gap	kløft
gulp	jafs
gulp, gorge	svelge
gum	gom
gum	gummiere
gum	tannkjøtt
gun	børse
gun	kanon
gunbarrel	geværløp
gunpowder	krutt
gunstock	geværkolbe
gunwale	reling
gurgle	klukke
gurgle, gargle	gurgle
gush, eruption	utbrudd
gut	sløye
gut	vom
gut, harsh	streng
gut, intenstine	tarm
gutter	rennestein
gutter	takrenne
guy	bardun
gymnasium	gymnastikksal
gymnast	gymnast
gymnast	turner
gymnastics, gymastics	gymnastikk
gynaecological	gynekologisk
gynaecologist	gynekolog
gypsum	gips
gypsy, gipsy	sigøyner
haberdashery	garn- og trådhandel
habit	drakt
habit	vane
habitability	beboelighet
habitat	voksested
habitation, dwelling, housing	bolig
habitual	sedvanlig
hacker	datasnok
hackneyed	forslitt
hackneyed, corny	banal
haddock	hyse
haddock	kolje
haemorrhage	blødning
haemorrhoids	hemmorider
haemostatic	blodstillende middel
hag	heks
hag	hurpe
haggard	uttært
haggle	prute
hail	hagl
hail	praie
hair	hår
hairdresser, barber	frisør
hairpiece	parykk
hairpiece	tupè
hairpin	hårnål
hairy	hårete
hairy	lodden
half	halv
half	halvdel
halibut	hellefisk
halibut	kveite
hall	entrè
hall	hall
hall	herregård
hallow	hellige
Halloween	Allehelgensaften
halt	stopp
halt	stoppe
ham	skinke
hammer	hammer
hammer	hamre
hammer	slegge
hammock	hengekøye
hamper	stor kurv
hamper, inhibit	hemme
hand	hånd
hand	rekke
handbook	håndbok
handbreak	håndbremse
handcuffs	håndjern
handicap	handikap
handicraft	håndverk
handkerchief	lommetørkle
handle	behandle
handle	hank
handle	håndtak
handle	håndtere
handle bars	sykkelstyre
handle bars, steering-wheel, rudder	ratt
handmade	håndlaget
handrail, banister	gelender
handwriting	håndskrift
handy	bekvem
handy, dexterous	fingernem
handy, practical	praktisk
handyman	altmuligmann
hang	henge
hanger	henger
hanging	hengning
hanging	opphengning
hangover	bakrus
hank	bunt
hanker	ha god lyst på
haphazardly	på måfå
happen	hende
happen, spoon	skje
happily	lykkelig
happilyness, happiness, fortune, felicity, luck	lykke
happy, glad, joyful	glad
harass, infest, harassment	plage
harassment	press
harbour	gi ly
harden	gjøre hard
harden	herde
hardly	neppe
hardly	nesten ikke
hardness	hardhet
hardship	motgang
hardware	jernvarer
hardware	maskinvare
hardy	hardfør
hare	hare
harebrained	tankeløs
harelip	hareskår
harlot	hore
harlot	skjøge
harm	ugang
harmless	uskadelig
harmless, inoffensive	harmløs
harmonious	harmonisk
harness	seletøy
harp	harpe
harp on	gnåle om
harp on	terpe på
harpsichord	cembalo
harrow	harv
harrow	harve
harsh	besk
hartshorn	hjortetakk
harvest	høste
harvest	innhøstning
harvest, crop	avling
hash	hakkemat
hash	hasj
hash	skjære i stykker
haste, hurry	hastverk
hasten	skynde på
hasten	skynde seg
hasty	forhastet
hasty	hissig
hat	hatt
hatch	klekke ut
hatch	ruge ut
hatch	skravere
hatchet	stridsøks
hate	hate
hatred, hate, animosity	hat
hatter	hattemaker
haughty	overlegen
haughty, arrogant	hovmodig
haul, catch	fangst
haul, drag	dra
haul, freight	frakt
haul, tail, lug	hale
haulage	transport
haunches	bakdel
haunches	ende
haunt	besøke ofte
haunt, habitat	tilholdssted
haunted	forpint
haunted	hjemsøkt
have	ha
have a fling	slå seg løs
have to	måtte
hawk	hauk
hawk	kremt
hawk, hem	kremte
hawker	gateselger
hawthorn	hagtorn
hayfever	høysnue
hazardous	risikabel
hazelnut	hasselnøtt
hazy	disig
he who	den som
head	lede
headache	hodepine
headlight	frontlys
headline, caption	overskrift
headmaster	rektor
headquarters	hovedkvarter
headstone	gravstein
headstrong	sta
headstrong	stri
headwind	motvind
headword	oppslagsord
heal	helbrede
heal up	gro
health	helse
health	sunnhet
healthfood	helsekost
heaped	toppet
heaps	massevis
hear	få vite
hear, listen	høre
hearing	hørevidde
hearing	høring
hearing	hørsel
hearing aid	høreapparat
hearse	likvogn
heart	hjerte
heartattack	hjerteanfall
heartburn	halsbrann
hearten, foster, encourage, lighten	oppmuntre
heartening	oppmuntrende
hearth	arne
hearth	peis
heartiness	hjertelighet
heartless	hjerteløs
heartrending	hjerteskjærende
hearts	hjerter
hearty, heartily	hjertelig
heat	heftighet
heat	hete
heat	løpetid
heat	pulje
heat	varme opp
heater	varmeapparat
heath	mo
heathen	hedensk
heathen, hedonist	hedning
heather	lyng
heating	oppvarming
heave	hale og dra
heave	lempe
heave to	legge bi
heave, displace	forskyve
heavenly	himmelsk
heavily	tungt
heck	pokker
heckle	hekle
heckle, discontinue, interrupt, disconnect	avbryte
heckler	møteplager
hectic	hektisk
hedge	innhegne
hedge, hedgerow	hekk
hedgehog	pinnsvin
hedonism	hedonisme
heed	ense
heel	sette hæl på
heel over	få slagside
heel, heel	hæl
heifer	kvige
height, highlight	høydepunkt
heir, heiress	arving
heirloom	arvestykke
hell	helvete
helmet	hjelm
help	hjelp
helpful	hjelpsom
helpful	nyttig
helping	prsjon
helpless	hjelpeløs
hem	fald
hem	falde
hem	søm
hem in	omringe
hemisphere	halvkule
hemp	hamp
hence, therefore	derfor
her	henne
herb	urt
herbaceous	urteaktig
herbal	urte-
herbicide	ugressmiddel
herbivorous	planteetende
herd	gjete
herdsman	gjeter
here	her
here by	herved
hereditary	arvelig
heredity	arvelighet
heresy	kjetteri
heretic	kjetter
heretical	kjettersk
heritage, inheritance	arv
hermit	eremitt
hernia	brokk
hero, quite, entirely	helt
heroes	helter
heroic	heroisk
heroine	heltinne
heroism	heltemot
heron	hegre
herring	sild
hers, her	hennes
herself	henne selv
hesitation	nøling
hibernate	gå i hi
hibernation	vinterdvale
hiccup	hikke
hide	gjemme
hide	skjule
hide and seek	gjemsel
hide, skin	hud
hideous, frightful	skrekkelig
hideous, ugly, nasty	heslig
hideout	gjemmested
hiding, flogging	pryl
hiding, indemnity	dekning
hidingplace	skjulested
highbrow	åndssnobb
highly	høyt
highminded, generous	høysinnet
highness	høyhet
highroad	landevei
highschool, grammarschool	videregående skole
highway	hovedvei
hijack	kapre
hijacker	kaprer
hike	fottur
hiker	turgåer
hikside, hillside	åsside
hill	bakke
hill	ås
hillside, hikside	li
him	ham
him, he	han
himself	han selv
hind	bak-
hind	hind
hinder, foil	forhindre
hindrance, hitch, encumbrance	hindring
hindsight	etterpåklokskap
hinge	hengsel
hinny	mulesel
hint	antydning
hint	ymte
hip	nype
hip, haunch	hofte
hip-pocket	baklomme
hipflask, flask	lommelerke
hipjoint	hofteledd
hippopotamus	flodhest
hipsocket	hofteskål
hirepurchase	avbetaling
his	hans
hiss	visle
hiss	vislelyd
historian	historiker
historic	historisk
history	historie
hit	fulltreffer
hit	suksess
hit	treffe
hit, beat	slag
hitch, jab	stikk
hitch, trouble, difficulty	vanskelighet
hitchhike	haike
hitherto, so far	hittil
hive, beehive	bikube
hives	elveblest
hoard	forråd
hoard	hamstre
hoarding	hamstring
hoarfrost	rimfrost
hoary	gråhåret
hoax	puss
hobgoblin	nisse
hobnob with	menge seg med
hog, pig	gris
hog, pig	svin
hogtie	binde på hender og føtter
hoist	heise
hold	holde
hold	inneholde
holder	holder
holder	innehaver
holding	gårdsbruk
holiday	fridag
holiday	helligdag
holiness	hellighet
holland	Holland
holland, Dutchland	Nederland
hollow	fordypning
hollow	hul
hollow	hulning
hollow	innfallen
holly	kristtorn
holster	hylster
holy	hellig
homage	hyllest
home	hjem
homeless	hjemløs
homely	enkel
homely, foul, nasty, ugly	stygg
homesickness	hjemlengsel
homewards	hjemover
homicide	mord
honest, frankly, candid	ærlig
honesty	ærlighet
honesty, fairness	redelighet
honey	honning
honeymoon	bryllupsreise
honeysuckle	kaprifolium
honk	tut
honorary	heders-
honorary	æres-
honour	heder
honour, glory	ære
honourable	hederlig
honourable	ærede
hood	hette
hood	kalesje
hoof	hov
hook	knagg
hook	krok
hook, chin	hake
hooked	hektet
hooked	kroket
hooked	krum
hooligan	bølle
hooligan	ramp
hoop	bøyle
hoop	tønnebånd
hoot	tuting
hoot	uling
hoot, honk	tute
hoot, howl	ule
hooter	bilhorn
hoover	støvsuge
hoover	støvsuger
hop, bumblebee	humle
hope	håp
hope	håpe
hopefully	forhåpentligvis
hopefully	håpefullt
horizon	horisont
horn	horn
hornet	geitehams
horny	hornaktig
horny	kåt
horrid	redselsfull
horrid, abhorrent	vemmelig
horrify	sjokkere
horrify, dismay	forferde
horrifying	forferdelig
horrifying	gruoppvekkende
horror	redsel
horse	hest
hose, stocking	strømpe
hose, tube	slange
hosiery	strikkevarer
hosiery	trikotasje
hospitable	gjestfri
hospital	hospital
hospital, infirmary	sykehus
hospitality	gjestfrihet
hospitalize	legge inn på sykehus
hostage	gissel
hostel	herberge
hostility	fiendtlighet
hostility, enmity, animosity	fiendskap
hot	het
hot	sterkt krydret
hot, warm	varm
hotel	hotell
hound	jakthund
hourly	hver time
housefly, fly	flue
household	husstand
housekeeper	husholderske
houses, house, home	hus
hovel	skur
hover, float	sveve
hovercraft	luftputefartøy
however	imidlertid
however, how	hvordan
hub	nav
hubbub	ståhei
hubbub, interference	støy
hubcap	hjulkapsel
huckster	høker
hue	anstrøk
hue, dye, colour	farge
huffy	fornermet
huffy	snurt
hug	klem
huge	kjempestor
huge, jolly	veldig
hull	belg
hull	skrog
hull, fan	rense
hull, skull	skalle
hum	nynne
hum	summe
human	mennesklig
humanity	menneskehet
humanity	mennesklighet
humble	beskjeden
humble	ydmyk
humble, humiliate	ydmyke
humbug	bløffe
humbug	bløffmaker
humbug, foul play, imposition	lureri
humidifier	luftfukter
humidity	fuktighet
humiliation	ydmykelse
humility	ydmykhet
hummingbird	kollibri
humorous	humoristisk
humour	humor
hump	kul
hunch, hump	pukkel
hunchbacked	pukkelrygget
hunger	sult
hungry	sulten
hunt	jakte
hunting, hunt	jakt
hurdle	forhindring
hurdle, impediment	hinder
hurl	slynge
hurl, throw	kaste
hurricane	orkan
hurried	oppjaget
hurry	haste
hurry, urgency	hast
hurt	sår
hurt, bruise, harm, injury, injure, detriment	skade
hurt, insult	såre
husband	ektemann
hushed	lavmælt
husk	skall
husk	skrelle
husky	rusten
husky, hoarse	hes
hustle	dytte
hustle	trekke på gaten
hustle, jam	trengsel
hutch, cage	bur
hydrangea	hortensia
hyena	hyene
hygiene	hygiene
hygienic	hygienisk
hymn	salme
hymn, anthem	hymne
hype	skudd
hype	sprøytenarkoman
hyphen	bindestrek
hypnosos	hypnose
hypnotic	søvndyssende middel
hypnotist	hypnotisør
hypnotize	hypnotisere
hypocrisy	hykleri
hypocrisy	skinnhellighet
hypocrite	hykler
hypodermic	underhuds-
hypothesis	hypotese
hysteric	hysterisk person
hysterical	hysterisk
hysterics	hysterisk anfall
i	jeg
ice	is
ice	ise
ice, glaze, enamel	glasere
iceberg	isfjell
icebreaker	isbryter
icecream	iskrem
iced	avkjølt
iced	med glasur
icicle	istapp
icing	isdannelse
icing sugar	melis
icy	isete
icy	iskald
idea	ide
idea	tanke
ideal	forbilde
ideal	ideell
idealism	idealisme
idealize	idealisere
identical	identisk
identification	identifikasjon
identify	identifisere
identity	identitet
identity card	identitetskort
idiom	idiom
idiom	språkeiendommelighet
idiot	idiot
idle, loaf	drive dank
idleness	lediggang
idleness, laziness	dovenskap
idling	tomgangskjøring
idol	avgud
idolize	forgude
idyll	hyrdedikt
idyll	idyll
if	hvis
ignitable, inflammable	antennelig
ignition, firing	tenning
ignoble	gemen
ignoble	ussel
ignominious	forsmedelig
ignominious, dishonourable	vanærende
ignorance	uvitenhet
ignorant	uvitende
ignore	ignorere
ignore	overse
ill, sick, diseased	syk
illegible	uleselig
illegitimate, illegal, illicit	ulovlig
illiteracy	analfabetisme
illiterate	analfabet
illuminated, enlightened	opplyst
illumination, information	opplysning
illumination, light, illustration	belysning
illusive, delusive, illusory	illusorisk
illustrate	belyse
illustrate	illustrere
illustrated	illustrert
illustration	illustrasjon
illustrious	fremtredende
image	ansikt utad
image, picture	bilde
imaginable, conceivable	tenkelig
imaginary	innbilt
imagination, fancy	fantasi
imagination, fancy	innbilning
imaginative, fanciful	fantasifull
imagine	innbille seg
imbibe, absorb	absorbere
imbibe, drink	drikke
imitable	etterlignbar
imitator	etterligner
immaterial	uvesentlig
immature	umoden
immediate	umiddelbar
immemorial	uminnelig
immerse, lower	senke
immigrant	innvandrer
immigrate	innvandre
immigration	innvandring
imminent, forthcoming	forestående
immoderate, immensely, exceedingly, immeasurably	umåtelig
immoral	umoralsk
immorality	umoralskhet
immortal	udødelig
immortality	udødelighet
immovable	ubevegelig
immovable	urokkelig
immune, impervious	uimottakelig
imp	djevelunge
imp	skøyer
impact	innvirkning
impaired	svekket
impart	gi videre
impassable	ufremkommelig
impasse	blindgate
impatience	utålmodighet
impatient	utålmodig
impeachment, incriminate	anklage
impeccable	plettfri
impeccable, immaculate	uklanderlig
impel	drive fram
impel	tilskynde
impending	nær forestående
impending, imminent	overhengende
impenetrable, impervious	ugjennomtrengelig
imperative	imperativ
imperative	myndig
imperfect	imperfektum
imperfect	ufullkommen
imperfection	ufullkommenhet
imperial	keiserlig
imperil	utsette for fare
imperishable	ubedervelig
impersonal, impersonal	upersonlig
impersonate, imitate, emulate	etterligne
impersonation, imitation	etterligning
impertinence	nesevishet
impertinent	nesevis
imperturbable	uforstyrrelig
impetuous, fierce, intense	voldsom
impetus	stimulans
impetus, impulse	impuls
impious	ugudelig
implement, instrument	verktøy
implicate	innvikle
implicate, imply	implisere
implication	innvikling
implication, involvement, interference	innblanding
implicit	stilltiende
implicit	underforstått
implore, entreat	bønnfalle
import	importere
import	innførsel
import, imply	innebære
import, introduce	innføre
importance	viktighet
important	viktig
impose, inflict	påtvinge
imposition	påbud
imposition	pålegg
imposition, tax, levy	skatt
impossibility	umulighet
impossible	umulig
impostor	bedrager
imposture, fraud	bedrageri
impotent	kraftløs
impoverish	gjøre fattig
impracticable	ugjennomførlig
impregnable	uinntagelig
impregnate	gjennomtrenge
impregnate	impregnere
impregnate	impregnert
impress	imponere
impress, print	trykke
impression	inntrykk
impressive, formidable, imposing	imponerende
imprint	innprente
imprint, impress	preg
imprint, impress	prege
imprint, impress, impression	avtrykk
imprison, grip, jail, captivate	fengsle
imprisonment	fangenskap
imprisonment	fengsling
improbability	usannsynlighet
improper, inappropriate	upassende
improvable	kan forbedres
improve, enhance	forbedre
imprudence	ubetenksomhet
imprudent	uklok
imprudent, indiscreet, inconsiderate	ubetenksom
impudence	uforskammethet
impudent, impertinent, insolent	uforskammet
impulse, inducement, incitement	tilskyndelse
impure	uren
in	hos
in	i
in	inn
in any case	i hvert fall
in any case	iallfall
in any case	uansett
in front of, before	før
in front of, before, fore	foran
in, indoor, inside, indoors	inne
in-laws	svigerfamilie
inability, incapability	manglende evne
inaccessible	utilgjengelig
inaccuracy	unøyaktighet
inaccurate	unøyaktig
inaction	uvirksomhet
inactive, idle	uvirksom
inadequate, deficient, insufficient	utilstrekkelig
inadmissible	kan ikke godtas
inadvertently	av vanvare
inapplicable	uanvendelig
inapplicable	ubrukelig
inasmuch as	ettersom
inattention	uoppmerksomhet
inattentive	uoppmerksom
inaugural	innvielses-
inaugurate	innsette
inauguration	innsettelse
inborn, innate, inherent	medfødt
incandescent	hvitglødende
incandescent lamp	glødelampe
incapacity	arbeidsuførhet
incapacity	inhabilitet
incapicitate	gjøre arbeidsufør
incapicitate	umuliggjøre
incendiary	brann-
incense	hisse opp
incense	røkelse
incentive	ansporende
incentive	incitament
incessant	uopphørlig
incestuous	skyldig i incest
inch	tomme
incidence, expansion	utbredelse
incident	episode
incident	innfallende
incident, happening	hendelse
incidental, casual, fortuitous, haphazard	tilfeldig
incidentally	forresten
incinerate	forbrenne
incinerate, burn	brenne
incinerator	forbrenningsovn
incision	innsnitt
incisive	skarpt
incite	anspore
incitement	spore
inclination	helling
inclination, bent, leaning	tilbøyelighet
incline	skråne
incline	skråning
inclined	skrånende
include	inkludere
include	omfatte
inclusive	inklusive
inclusive	samlet
incoherent, disconnected, disjointed	usammenhengende
income	inntekt
incoming	innkommende
incomparable	usammenlignbar
incompetent	inhabil
incompetent, incapable	uskikket
incomplete	uferdig
incomplete	ufullstendig
incomprehensible	uforståelig
inconceivable	ufattelig
incongruous	uoverstemmende
inconsiderable	ubetydlig
inconsiderate	hensynsløs
inconsistent	inkonsekvent
inconsistent	selvmotsigende
inconvenience	bry
inconvenience	uleilighet
inconvenient	brysom
inconvenient	ubeleilig
inconvenient, difficult, hard	vanskelig
incorporate	innlemme
incorporated	innlemmet
incorrect	uriktig
incorrigible	uforbederlig
increase	tilta
increase, boost, gather, enhance	øke
increase, growth	vekst
increase, heighten	forhøye
incredible	utrolig
incredulous, dubious	tvilende
increment	tillegg
incriminate	belaste
incubator	kuvøse
incubator	rugemaskin
incur	utsette seg for
incurable	uhelbredelig
indebted	stå i gjeld
indecency	uanstendighet
indecent	uanstendig
indecision	ubesluttsomhet
indecisive, irresolute	ubesluttsom
indeed	ja visst
indeed	riktig nok
indeed	sannelig
indefatigable	utrettelig
indefensible	ikke kan forsvares
indefensible	uholdbar
indefinite	ubegrenset
indefinite	ubestemt
indelible	uutslettelig
indelicacy, indiscretion	taktløshet
indemnity	skadeserstatning
indent	skjære hakk i
indent for	rekvirere
indent, instructions	ordre
indentation	hakk
indentation	innrykk
indentation, hack	skår
independence	uavhengighet
independent	uavhengig
indestructible	kan ikke ødelegges
indestructible, imperishable	uforgjengelig
index	register
index	registrere
index, forefinger	pekefinger
index, indicator	viser
indicate	indikere
indicate	markere
indicate	visse
indication	tegn
indict	reise tiltale mot
indictment	tiltale
indifference	likegyldighet
indifferent	likegyldig
indifferent	middelmådig
indigenous	innfødt
indigestible	ufordøyelig
indigestion	dårlig fordøyelse
indignant	indignert
indignant	vred
indignation	harme
indiscernable, imperceptive	umerkelig
indiscreet	indiskret
indiscretion	indiskresjon
indiscriminate	kritikkløs
indiscriminate	vilkårlig
indispensable	uunnværlig
indisposed	utilpass
indisposition	utilpasshet
indisposition, grudge	uvilje
indisputable	ubestridelig
indissoluble, insoluble	uoppløselig
indistinct	utydelig
indistinctive	ukarakteristisk
individual	individ
individual	individuell
individual	personlig
individual	særskilt
indivisible	udelelig
indolence	lathet
indolence	treghet
indomitable	ukuelig
indomitable	utemmelig
indoors	innendørs
indubitable	utvilsom
induce	forårsake
induce, coax	overtale
indulge	føye
indulge	gi etter for
indulgence	ettergivenhet
indulgent	ettergivende
indulgent	overbærende
industrial	industri-
industrial	industriell
industrious, diligent	flittig
industry	industri
industry	næringsvei
inebriated	beruset
ineffective	ineffektiv
ineffective, inoperative	virkningsløs
inefficient, inept	udugelig
inept	ukyndig
inept, inane, daft, foolish	tåpelig
inept, inappropriate	malplassert
inequitable, iniquitous	urettferdig
ineradicable	uutryddelig
inevitable	uunngåelig
inexorably	ubønnhørlig
inexpedient	uhensiktsmessig
inexpensive, cheap	billig
inexperienced, fresh	uerfaren
inexplicable	uforklarlig
inexpressible	uutsigelig
inexpressible, indescribable	ubeskrivelig
inexpressive	uttrykksløs
inextricable	sammenfiltret
infallible	ufeilbarlig
infancy, childhood	barndom
infant	spedbarn
infantile	barnslig
infantile	infantil
infantry	infanteri
infatuated	blindt forelsket
infatuation	blind forelskelse
infect	infisere
infect, infection, contagion	smitte
infection	infeksjon
infectious	smittende
infer, insinuate, intimate, hint, imply	antyde
inference	slutning
inferior	dårligere
inferior	mindreverdig
inferior	underordnet
inferiority complex	mindreverdighetskompleks
infernal	fordømt
infernal	helvetes
infernal, confounded	pokkers
infertile, barren	ufruktbar
infertility	ufruktbarhet
infest	hjemsøke
infidelity	utroskap
infiltrate	infiltrere
infinite, interminable, endless	uendelig
infinity	uendelighet
infirm	svakelig
infirmity	svakelighet
infirmity, frailty	skrøpelighet
inflamed	betent
inflamed	opphisset
inflammable	brennbar
inflammation	betennelse
inflate	pumpe opp
inflated	oppblåst
inflation	inflasjon
inflation	oppblåsing
inflect	bøye
inflect	modulere
inflection	bøyning
inflection	modulasjon
inflict	tildele
influence	influere
influence	innflytelse
influential	innflytelsesrik
influenza	influensa
inform	meddele
inform	underrette
informal, intimate	uformell
informer	angiver
infringe, contravene	overtre
infuriating	meget irriterende
infuse	sette mot i
ingenious, inventive	oppfinnsom
ingenuity	lurt påfunn
ingenuous	troskyldig
ingrained	gjennomfarget
ingrained, inveterate	inngrodd
ingratitude	utakknemlighet
ingredient	besstanddel
ingredient	ingrediens
inhabit	bebo
inhabitable, habitable	beboelig
inhabitant	innbygger
inhale	innhalere
inhaler	inhalator
inharmonious	uharmonisk
inherent	iboende
inherit	arve
inhibit, encumber, impede, hinder, hamper	hindre
inhibition	hemning
inhibitive	hemmende
inhospitable	ugjestfri
inhuman	umenneskelig
inimical, adverse, hostile	fiendtlig
iniquitous, infamous, disgraceful	skammelig
initial	begynnelses-
initial	forbokstav
initiate	innlede
initiate	inviet
initiate, hallow, inaugurate, consecrate	innvie
initiation, inauguration	innvielse
inject	sprøyte inn
injection	innsprøytning
injection, hype, hypodermic	sprøyte
injure	krenke
injurious	krenkende
injury, invasion	krenkelse
injustice	urettferdighet
ink, ink	blekk
inkling, hunch	anelse
inland	innland
inlet	innløp
inmate	innsatt
inmate, inhabitant	beboer
inn	kro
inn	vertshus
innermost	innerst
innocence	uskyld
innocence	uskyldighet
innocent	uskyldig
innovation	fornyelse
innovation	nyskapning
innuendo	insinuasjon
innumerable	talløs
innumerable	utallig
inoculate	vaksinere
inordinate, excessive, immoderate	overdreven
inquest	likskue
inquiry, enquiry	forespørsel
inquisitive	vitebegjærlig
insane	sinnsyk
insanity	sinnssykdom
insanity	vannvidd
inscribe	dedisere
inscription	inngravering
inscription	innskripsjon
insect, bug, insect	insekt
insecticide	insektmiddel
insecure, faltering	usikker
insensibility	følelsesløshet
insensible	følelsesløs
insensible, callous	ufølsom
inseparable	uatskillelig
insert	rykke inn
insert	sette inn
insert	skyte inn
inside	innside
inside, inwardly, internal, indoor, interior	innvendig
insider trading	innsidehandel
insight	innsikt
insincere	uoppriktig
insipid	flau
insipid	smakløs
insist	insistere
insist on	fastholde
insistent	pågående
insoluble, inextricable, indissoluble	uløselig
insomnia	søvnløshet
inspect	inspisere
inspect	kontrollere
inspection	inspeksjon
inspection	kontroll
inspector	inspektør
inspiration	inspirasjon
inspire	inspirere
instability	ustabilitet
instable	ustabil
install	insette
install	installere
instalment	avdrag
instalment	porsjon
instance, example	eksempel
instant	øyeblikk
instant coffee	pulverkaffe
instant, immediate	øyeblikkelig
instantaneous	momentant
instantly, forthwith, immediately	straks
instead	isteden
instead of	istedenfor
instep	vrist
instigate	tilskynder
instigate, incite, goad	egge
instill	inngyte
instill, inoculate	innpode
instinct	instinkt
instinctive	instinktiv
instinctive	uvilkårlig
institute	institutt
institution	institusjon
institutionalize	anbringe på institusjon
instruct	instruere
instruct	undervise
instruction	instruksjon
instruction, education	undervisning
instructions	bruksanvisning
instructions	instruks
instructive	lærerik
instructor, teacher	lærer
instrument	instrument
instrument	instrumentere
instrumental	instrumental
instrumental	medvirkende
insubordinate	oppsetsig
insubordinate, disobedient	ulydig
insufferable, untolerable, intolerable	utålelig
insuing, following	påfølgende
insularity	øyboermentalitet
insulation, isolation, insulation	isolasjon
insulator	isolator
insult	fornærme
insult	fornærmelse
insuperable	uoverkommelig
insurance	forsikring
insurmountable, insuperable	uoverstigelig
insurrection	opprør
intangible	uhåndgripelig
intangible	vag
integer	heltall
integral	helhetlig
integral	integral
integral	integrerende
integrate	integrere
integrity	helhet
integrity	integritet
integrity	rettskaffenhet
intellect	forstand
intellectual	forstandsmessig
intellectual, highbrow	intellektuell
intelligence	etterretning
intelligence	intelligens
intelligent	intelligent
intelligible	forståelig
intemperance	mangel på måtehold
intend	ha til hensikt
intended	tilkommende
intense	intens
intensification	forsterkning
intensify	intensivere
intensity	intensitet
intent	spent
intention	formål
intention, idea	hensikt
intentional	tilsiktet
interaction	vekselvirkning
intercede	megle
intercept	avskjære
intercept	snappe opp
interceptor	nærjager
interchange	utveksle
intercourse	samkvem
interest	interesse
interest	interessere
interest	rente
interesting, intriguing	interessant
interface	grensesnitt
interfere	blande seg opp i
interference	rad
interlock	blokkere
interlock	passe
interlock	sperre
interlude	mellomspill
intermediary	mellommann
intermediate	mellom-
intermediate, interjacent	mellomliggende
interminable, endless	endeløs
intermittent	periodisk
intern	internere
international	internasjonal
internee	internert
internment	internering
interplay	samspill
interplay	vekselspill
interpolate	innskyte
interpolate	interpolere
interpose	gripe inn i
interpose	komme mellom
interpret	tolke
interpret	tyde
interpretation	fortolkning
interpretation	tolkning
interpreter	tolk
interrogate	forhøre
interrogation	forhør
interrogation	utspørring
interrogative, quizzical	spørrende
interruption, intermission	avbrytelse
intersect	gjennomskjære
intersection	skjæringspunkt
interval	mellomrom
interval, intermission, interlude	pause
intervene	gripe inn
intervene	intervenere
intervention	intervensjon
interview	intervju
interview	intervjue
interview, conversation	samtale
intimate, familiar	fortrolig
intimidate, scare, frighten	skremme
intimidation	skremming
intinerary	reiserute
into	inn i
intolerable, excruciating, insupportable	uutholdelig
intolerant	intolerant
intonation	intonasjon
intonation, accent	tonefall
intoxicant	rusmiddel
intoxicate	beruse
intoxication	beruselse
intoxication	rus
intrepid	uforferdet
intrepid, fearless	fryktløs
intricate	innviklet
intrigue	intrige
intrigue	intrigering
intriguing	intregant
intrinsic, inside, internal, inner, interior	indre
introduce	introdusere
introduce	presentere
introduction	presentasjon
introduction, initiation	innledning
introductory	innledende
intrude	trenge på
intrude, disturb	forstyrre
intruder, invader	inntrenger
intrusion, disturbance	forstyrrelse
intrusive	påtrengende
intuition	intuisjon
intuitive	intuitiv
invade	invadere
invalid	invalid
invalid	ugyldig
invalid, disabled	ufør
invalidate	gjøre ugyldig
invaluable, inestimable	uvurderlig
invariable	uforanderlig
invariably, ever	alltid
invasion	invasjon
invent	oppfinne
invention	oppfinnelse
inventor	oppfinner
inventory	inventarliste
inverse, inverted	omvendt
inversion	inversjon
invert	invertere
inverted	speilvendt
invest	investere
investigate	etterforske
investigate, examine	undersøke
investigation	etterforskning
investigation	granskning
investment	investering
investor	investor
invigorate, force, intensity	styrke
invigorating	forfriskende
invincible	uovervinnelig
inviolable	ukrenkelig
invisible	usynlig
invitation	invitasjon
invitation	oppfordring
invite	innby
invite	oppfordre
inviting	innbydende
invoice	faktura
invoice	fakturere
invoke	anrope
invoke	påkalle
involuntary	ufrivillig
involve	involvere
involve	trekke inn
involvement, engagement	engasjement
invulnerable	usårbar
inwards	innover
iodine	jod
irksome	kjedsommelig
ironic	ironisk
irony	ironi
irrational	fornuftsstridig
irrational	irrasjonell
irreconcilable	uforsonlig
irreconcilable, incompatible	uforenlig
irregular	uregelmessig
irregularity	uregelmessighet
irrelevance	irrelevanse
irrelevant	irrelevant
irreprochable, immaculate	ulastelig
irresistible	uimotståelig
irresponsible	uansvarlig
irretrievable, irreparable	uopprettelig
irreverent	respektløs
irrevocable	ugjenkallelig
irrigate	overrisle
irrigate	vanne
irrigation	overrisling
irrigation	vanning
irritable, edgy	irritabel
irritation	ergrelse
irritation	irritasjon
is, am	er
isle, island	øy
isler	øyboer
isolate, insulate	isolere
issue	utgi
issue	utstede
issue	utstedelse
it	den
it	det
itch	klø
itch	kløe
itch	skabb
item	artikkel
item, post, mail	post
item, spot, point, dot, period	punkt
itemize	spesifisere
itinerant	omreisende
its	dens
its	dets
its	sin
its	sine
itself	seg
itself	selv
ivory	elfenben
ivy	eføy
jack	jekk
jack knife	foldekniv
jackal	sjakal
jacket	jakke
jaded	sløvet
jaded	trett
jag	rangel
jag	spiss
jag, barb	tagg
jagged	taggete
jam	blokkering
jam	knipe
jam	syltetøy
jangle	rasle
jangle	rasling
jangle	skramle
jangle	skramling
janitor	portvakt
janitor	vaktmester
January	januar
Japanese	Japansk
jar	ryste
jar, quake	rystelse
jaundice	gulsott
jaunt	kort tur
jaunty, gay	munter
javelin	spyd
jaw	gap
jaw	kjefte
jaw	kjeve
jaw, gab	skravle
jay	nøtteskrike
jeakousy	sjalusi
jealous	sjalu
jeer	håne
jeer, gibe	spotte
jelly	gelè
jellyfish	manet
jeopardize	sette på spill
jeopardize, endanger	bringe i fare
jerk	rykke
jerk, fool	tosk
jerk, haul	rykk
jester	narr
jester	spøkefugl
jet	jetfly
jet	stråle
jet, gush	sprut
jew	jøde
jewel	juvel
jewel, adorn	smykke
jeweller	gullsmed
jewellery	smykker
jewish	jødisk
jib	klyver
jib	utligger
jig	gigg
jig	pilk
jigsaw puzzle	puslespill
jigsaw, fretsaw	løvsag
jingle	klirre
jingle	klirring
jingle	ringle
job	jobb
job	jobbe
job	spekulere
jockey	jockey
jockey	manøvrere
jog	jogge
jog, jostle	puffe
join, joint	skjøte
join, link	forbinde
join, yoke	forene
joint	felles-
joint	skjøt
joke, hoax, jest	spøk
joke, jest, haunt	spøke
jolly, merry, cheerful, gay	lystig
jolt	skumpe
jolt	støte
jolt, jog, impact	støt
jostle, hustle	skubbe
jot	døyt
journal, daily paper, newspaper	avis
journalism	journalistikk
journalist	journalist
jovial	gemyttlig
jowl	underkjeve
joyful	gledelig
joystick	styrespake
jubilee	jubileum
judge	anse for
judge	dommer
judge, doom	dømme
judgement	dom
judicial	rettslig
judicious	klok
jug	mugge
jug, pot	potte
juggle	sjonglere
juggler	sjonglør
juice	saft
juicy, luscious	saftig
July	juli
jumble	virvar
jumble sale, fleamarket	loppemarked
jumper	hopper
jumper cables	startkabler
jumpy	urolig
junction	knutepunkt
junction, cross, intersection	kryss
June	juni
jungle	jungel
junior	junior
junior	yngre
juniper	einer
junk, drug	narkotika
junkie	narkoman
junkie, addict	stoffmisbruker
junkshop	skraphandel
juridical, legally, judicial	juridisk
jurisdiction	domsmyndighet
jurisprudence	rettsvitenskap
jury	jury
just	bare
just	rettferdig
just	rimelig
just, exactly	nettopp
justice	berettigelse
justice, fairness	rettferdighet
justifiable	forsvarlig
justification	rettferdiggjørelse
justify	rettferdiggjøre
jut	stikke fram
juvenile	ungdoms-
juvenile delinquent	ungdomsforbryter
juxtaposition	sidestilling
kangaroo	kenguru
keel	kjøl
keen, acute	skarp
keen, zealous, eager, fervent	ivrig
keep	beholde
keepsake, souvenir, memento, monument	minnesmerke
keg	tønne
keg, dish, course, platter	fat
kerosene, paraffin-oil, petroleum	parafin
kettledrum	pauke
kettleholder	gryteklut
keyboard	klaviatur
keyboard	tastatur
keyhole	nøkkelhull
keyring	nøkkelring
kick	spark
kid	erte
kid	geitekilling
kid	unge
kidney	nyre
kill	drepe
killer	morder
kilo	kilo
kin	slekt
kindergarten	barnehage
kindle, light	tenne
kindred	beslektet
kindred	slektskap
king	konge
kingdom	kongerike
kipper, red herring	røkesild
kirk, church	kirke
kitbag	reiseveske
kitchen	kjøkken
kitchenette	tekjøkken
kite	papirdrage
kitten	kattunge
knack	ferdighet
knack	håndlag
knapsack	ransel
knave	kjeltring
knead	elte
knead	kna
knee	kne
kneecap	kneskål
kneejoint	kneledd
kneel	knele
knickers	nikkers
knickers	underbukser
knife	kniv
knight	ridder
knit	strikke
knitting	strikketøy
knittingneedle	strikkepinne
knittingwool, yarn	garn
knob	knott
knob, knot	knute
knobbly	knudret
knocker	dørhammer
knoll	knaus
knoll, heap	haug
knot	knop
knot, cluster, huddle	klynge
know	kjenne til
know	kunne
know	vite
knowing	megetsigende
knowledge	kjennskap
knowledge	kunnskap
knowledgeable	kunnskapsrik
knuckle	knoke
knuckleduster	slåsshanske
knurled	riflete
knurled	rulettert
label	etikett
label	merkelapp
label	stemple
laboratory	laboratorium
laborious	strevsom
labour	arbeide
labour	arbeidskraft
labour	stri med
lace	knipling
lace	lisse
lace	snøre
lacerate	lage rift i
lack	mangle
ladder	leider
ladder, flow	stige
laden	lastet
laden	nedtynget
ladle	sleiv
ladle	øse
lady	dame
lady, madam	frue
lag	sommel
lagoon	lagune
lair	hi
lake, loch	innsjø
lake, loch	sjø
lamb	lam
lamb	lamme
lame	halt
lament	jamre
lament	klagesang
lament, complain	klage
lamp	lampe
lamp post	lyktestolpe
lamp shade	lampeskjerm
lampoon	smedeskrift
lance	lanse
lance	stikke hull på
land	havne
land	lande
land, country	land
landholder	grunneier
landing	landing
landing	landsetting
landing	nedslag
landing	trappeavsats
landingslope	unnarenn
landlady, hostess	vertinne
landlord, host	vert
landscape	landskap
landslide, avalanche	skred
lane	kjørefelt
languid, dull, inert, indolent	treg
languish	vansmekte
languor	sløvhetstilstand
lank, flush, glib, glossy, icy, even	glatt
lank, haggard, lean	mager
lantern	lanterne
lantern	lykt
lap	runde
lap	skvalpe
lapdog	skjødehund
lapel	jakkeslag
lapse	forfalle
lapse, decline, decay, decadence	forfall
laptime	rundetid
laquer	lakk
laquer	lakkere
larch	lerk
lard	smult
larder	spiskammer
largely	overveiende
lark	lerke
lark, fun	moro
larkspur	ridderspore
larynx	strupehode
lash	piskeslag
lash	snert
lash	øyenvipp
lass	ungjente
last	forrige
last, item	vare
last, latter	siste
lastly	til slutt
latch	klinke
latch	smekklås
late	sein
late, belated	forsinket
latecomer	etternøler
lately	i det siste
lateral	side-
lath	lekte
Latin	Latinsk
latitude	breddegrad
latitude	spillerom
latter	sistnevnte
lattice bars	sprinkler
lattice, grid, grate	gitter
laudable	rosverdig
laugh, laughter	latter
laugh, lee	le
laughing	leende
launch	lansering
launch	sjøsette
launch	stabelavløpning
launch	utskytning
launderette, laundry	vaskeri
laundry	vask
laurel	laurbær
lavender	lavendel
lavish	ødsle bort
lavish, luxurious	overdådig
law	jus
law	lov
law	rett
lawful	rettsmessig
lawless	lovløs
lawn	gressplen
lawnmower	gressklipper
lawsuit	rettsak
lawyer	jurist
lax, floppy, limp, flabby	slapp
laxative	avføringsmiddel
laxity	slapphet
lay	kvad
lay	legge
lay hold of, pick up	ta
lay-by, parking garage, parking bay, car park	parkeringsplass
layer	lag
layercake	bløtkake
layman	lekmann
lazy, idle	doven
lazy, indolent	lat
lead	bly
lead	forsprang
lead	hovedrolle
lead	lodd
lead, hint	vink
leaded	med bly
leaden	blyaktig
leading	ledende
league	liga
leak	lekk
leakage, leak	lekkasje
lean	lene
leap, hop, jump	hopp
leap, hop, jump	hoppe
leap, jump	sprang
learn	erfare
learned	lærd
learner	elev
learning	læring
lease	bygsel
lease	bygsle
lease	leiekontrakt
leasehold	bygslet grunn
leaseholder	forpakter
leaseholder	leier
leash	hundebånd
leash	koppel
least, lesser	minst
leather	lær
leathery	læraktig
leathery	seigt
leave	etterlate
leave	permisjon
leave, departure	avreise
leaven	surdeig
leaves, leaf	løv
lecherous	lidderlig
lecture	forelesning
lecture, discourse	foredrag
lecturer	foreleser
lecturer	universitetslektor
ledge	hylle
ledger	hovedbok
ledger	reskontro
leech	igle
leek	purre
leer	lystent blikk
left, on the left	venstre
left-handed	keivhendt
leg	etappe
leg, thigh	lår
legacy	testamentarisk gave
legal, lawful	lovlig
legality	lovlighet
legalize	legalisere
legalize, legitimate	lovliggjøre
legally	legalt
legation	legasjon
legend	legende
legend	sagn
legendary	legendarisk
leggings	gamasjer
legible	leselig
legislation	lovgivning
legislative	lovgivende
legitimate	ektefødt
legitimate	legitimere
legitimate	lovmessig
leisure	fritid
lemon	sitron
lemonrind	sitronskall
lend	låne ut
lender	utlåner
length	lengde
lengthen, extend	forlenge
lenient	skånsom
lens	objektiv
lentil, lens	linse
leper, leprous	spedalsk
leprosy	spedalskhet
lesbian	lesbisk
lesion	lesjon
less	minus
lessen	minske
lesser, less	mindre
lesson	lekse
lesson	lærepenge
lesson	undervisningstime
let	la
lethal	dødelig
letter	bokstav
letter	brev
letterbox, mailbox	postkasse
lettuce	bladsalat
level	nivå
level	plan
level	strøken
level	vannrett
lever	jekke
lever	spak
lever	vektstang
levity	lettsinn
levy	innkreve
levy, enjoin, impose	pålegge
lewd	utuktig
liabilities	passiva
liability	forpliktelse
liable	ansvarlig
liable, inclined	tilbøyelig
liaison	kjærlighetsaffære
liaison	samband
liar	løgner
libel	injurie
libel	injuriere
libel action	injuriesak
libel damages	injurieerstatning
liberal	frisinnet
liberal	liberal
liberal, freehanded	gavmild
liberation	befrielse
liberty, freedom	frihet
librarian	bibliotekar
library	bibliotek
licence	bevilling
licence	lisens
licence, levy	avgift
licentious	tøylesløs
licentious, dissipated, dissolute	utsvevende
lick	slikk
lick	slikke
licorice, liquorice	lakris
lid, cover	lokk
lie	ligge
lie	lyve
lieutenant	løytnant
lifejacket	redningsvest
lifeless	livløs
lifelike	realistisk
lifelong	livsvarig
lifetime	livstid
lift	haik
lift	løft
lift, elevator	heis
ligament	bånd
ligament	ligament
light, lighten	lyse
lighten, enlighten	opplyse
lightning	lyn
lightning rod	lynavleder
like	som
likeable	sympatisk
likelihood	sannsynlighet
likely	sannsynlig
liken	sammenligne
likeness, equality	likhet
likewise	likeledes
likewise	likeså
liking	forkjærlighet
lilac	syrin
lilac, purple	lilla
lily	lilje
limb	lem
lime	kalk
lime	limettsitron
limit, confine	begrense
limit, frontier, boundary	grense
limitation	begrensning
limp	halte
limp	halting
linden, lime	lind
line	bransje
line	linje
line	linjere
line	snor
line	strek
line, fringe	kante
linen cloth	lærret
linen goods	hvitevarer
liner	rutebåt
liner	rutefly
linger	somle
lingerie	dameundertøy
lingering	dvelende
lingering	langvarig
lingual	tunge-
linguistic	språklig
liniment	salve
link, fetter	lenke
link, joint	ledd
linked	sammenkoblet
linseed	linfrø
lion	løve
lip	leppe
liposuction, fatsuction	fettsuging
lipstick	leppestift
liquefied	kondensert
liqueur	likør
liquidate	avvikle
liquidate	likvidere
liquidity	likviditet
lisp	lespe
list	liste
list	listeføre
list	slagside
list, inventory	fortegnelse
listen	lytte
listener	tilhører
listless	giddeløs
literacy	leseferdighet
literacy	skriveferdighet
literal	bokstavelig
literal	ordrett
literary	litterær
literature	litteratur
litre, liter	liter
litterbin	papirkurv
little	lite
little	litt
live	leve
livelihood, living	levebrød
liver	lever
liverpaste	leverpostei
lives, life	liv
livestock	husdyrbestand
livestock farming	kvegavl
livid	bleik
livid	gusten
living	levende
living	livsførsel
lizard	firfirsle
load	belastning
load	lade
load	laste
load, cargo, lading, freight	last
loading	lading
loading	lasting
loafer, idler	dagdriver
loam	leirjord
loan	lån
loan	utlån
loathe, loathing, detest, disgust, abhor	avsky
loathsome, disgusting	motbydelig
lob	lobbe
lobby	foajè
lobby	korridor
lobbyist	korridorpolitiker
lobe	flik
lobe	lapp
lobster	hummer
local	kommunal
local	lokal
local	stedlig
locality	beliggenhet
locality, location	sted
localize	stedfeste
localize, locate	lokalisere
locate	plassere
location	plassering
lock	hårlokk
lock	låse
lock	sluse
lock gate, floodgate	sluseport
locker	skap
locket	medaljong
locksmith	låsesmed
locomotive	bevegelses-
locomotive	lokomotiv
lodge	losje
lodge	losjere
lodger	leieboer
lofty	oppløftet
lofty, hay, loud, high, tall	høy
log	loggbok
log	tømmerstokk
logic	logikk
logical	logisk
loin	kam
loin	lend
long	lang
long	lenge
long, yearn	lengte
longing	lengselsfull
longing, yearning	lengsel
longitude	lengdegrad
longitudinal	langsgående
longitudinal	lengde-
look	mine
look	utseende
look, find	synes
loom	vevstol
loop	løkke
loop	sløyfe
loophole	smutthull
loose	løs
loose, vast, wide, extensive, spacious	vid
loosen	løsne
loot	tyvegods
loot, fleece	plyndre
lopsided	usymmetrisk
lopsided, leaning	skjev
lorry, truck	lastebil
lose	miste
lose	saktne
lose	tape
loser	taper
loss	savn
loss	tap
lot	loddtrekning
lotion	fuktighetskrem
lottery	lotteri
loud, clamorous	skrikende
lounge	dovne seg
lounge suite	sofagruppe
lounge, couch	salong
lounge, lobby	vestibyle
lounge, loiter	slentre
louse	lus
lousy	elendig
lousy	lusete
lout	slamp
lovable	elskelig
love	elske
love	elskede
love	kjæreste
love	kjærlighet
lovely	yndig
lover	elsker
lovers	elskende
lovers	elskere
loving, fond	kjærlig
low	simpel
low, deep, profound, depth	dyp
low, lichen	lav
lower	nedre
lower	under-
lower, four	fire
lower, inferior	lavere
lownecked	utringet
loyal	lojal
loyal, faithful	trofast
loyalty	lojalitet
lozenge	pastill
lubricant	smøremiddel
lubrication	smøring
luck	hell
lucky, fortunate	heldig
lucrative	innbringende
lucrative	lønnsom
ludicrous, laughable	latterlig
lug	slepe
luggage	reisegods
lukewarm	lunken
lull	opphold
lullaby	vuggesang
lumber	tømmer
lumber, junk	skrap
luminous	selvlysende
lump	hevelse
lump	klump
lump	klumpe
lunar	måne-
lunatic	galning
lung	lunge
lunge	utfall
lurch	krenging
lurch	sjangle
lure, bait	lokkemat
lurid, fervent	glødende
lurk	ligge på lur
luscious, dainty	lekker
lust	lyst
lust	vellyst
lustful, lascivious	vellystig
lustrous	skinnende
luxurious	luksuriøs
luxury	luksus
lye	lut
lymphatic node	lymfeknute
lynch	lynsje
lynx	gaupe
lyric	lyrisk
lyrics	sangtekster
lyrics	vers
macaroon	makron
mace	septer
machine, machine, engine	maskin
machinery	maskineri
mackerel, mackerel	makrell
mackintosh	regnfrakk
mad	gal
mad, furious, madden	rasende
madam	frøken
madden	gjøre gal
madness, lunacy	galskap
magazine	lagerbygning
magazine	magasin
maggot, caterpillar, grub	larve
magic	magi
magic wand	tryllestav
magic, magical	magisk
magician	magiker
magician	trollmann
maid	kammerpike
maid	stuepike
maid	værelsepike
maize, mealies, corn, indian corn	mais
major road	vei med forkjørsrett
make-up	sminke
male cook, cook	kokk
man, human being, human being	menneske
mantle	kåpe
marble	klinkekule
March	mars
marmelade	marmelade
marriage, matrimony	ekteskap
match	fyrstikk
matter, business deal, business, case, affair	anliggende
mattress	madrass
mature, ripe	moden
May	mai
meal, flour	mel
meat, flesh	kjøtt
medicine, drug, pharmaceutical	medisin
melon	melon
menu	spisekart
menu, card, map	kart
merchant, grocer	kjøpmann
messenger	budbringer
metal	metall
meter, metre	meter
methylated spirit	denaturert sprit
metropolis, capital city	hovedstad
milk	melk
minced meat	kjøttkaker
mineral	malm
minute	minutt
mirror, glass	speil
mistake, error	mistak
misunderstanding	misforstælse
monday	mandag
money	penger
money order	postanvisning
month	måned
moon, moon	måne
moor	fortøye
moped	moped
morning	morgen
mother	mor
mother-in-law	svigermor
motion picture, film, movie	film
motor, engine	motor
motorcycle	motorsykkel
mountain	fjell
mouse	mus
mousepad	mus-matte
mouth	munn
move, induce	bevege
multimedia	multimedia
museum	museum
mushroom, fungus	sopp
music	musikk
mustard	sennep
nail	negl
nail	spiker
nail-varnish	neglelakk
name, appellation	navn
napkin	serviett
narrow	smal
narrow, cramped	trang
nature	natur
near to, nearby, by, close, beside, next to	nær
neck	hals
needle	nål
needle, pin	knappenål
neighbour, neighbor	nabo
nephew	nevø
nervous, jittery, excitable, jumpy, fraught	nervøs
neutral	nøytral
never	aldri
new, novel, fresh	ny
night	natt
nine	ni
nineteen	nitten
ninety	nitti
ninth	niende
nipple	brystvorte
no, not	ikke
noise	støy. bråk
noise, din, din, ado	larm
noon, midday meal, dinner, midday	middag
north	nord
norwegian	norsk
not, no	ne
note, ticket, bill	billett
nourishment	næring
November	november
null, naught, zilch, zero, nought	null
number, amount	nummer
numberplate	nummerskilt
nurse	sykepleierske
nut	mutter
nut	nøtt
nylon	nylon
oak	eik
oar	åre
oats	havre
object, thing, article	ting
October	oktober
office, bureau	kontor
oil	olje
okay, good, nice	god
old, ancient	gammel
olive	oliven
omelet, omelette	omelett
on the right	høyre
on top, upstairs, above, overhead	ovenpå
on, upon, in	på
one hundred, hundred, hundred	hundre
one thousand, thousand	tusen
one, a	en
one-way traffic	enveiskjøring
onerous, burdensome, heavy, hard	tung
onion	løk
open, frank	åpen
opera	opera
orange	appelsin
orange-coloured	orange
out, abroad, outside	utenfor
outer cover, tyre	dekk
over, above	over
overcoat, coat	frakk
packet, parcel	pakke
padlock	hengelås
pain	smerte
painter	maler
panic	panikk
pants, trousers	benklær
paper	papir
paper, document	dokument
parachute	fallskjerm
parents	foreldre
park	park
parsley	persille
partridge	åkerhøne
passport	pass
paste	lime inn
pate, head	hode
path	sti
pattern, specimen, sample	mønster
paw, foot, feet	fot
paw, leg, bone	ben
pay	betale
pea	ert
peace	fred
peach	fersken
pear, bulb, pear	pære
pedal	pedal
pelvis, bowl	skål
pen	penn
pen-knife	lommekniv
pencil	blyant
pepper	pepper
perform, do, make	gjøre
periodical, magazine, newspaper	tidskrift
petticoat	underskjørt
photographer	fotograf
physician	dokter
piano	piano
pick	pirke
pick	plukke i
pick, elect	velge
pick, hack, hoe	hakke
picture, painting	maleri
pill, husk	pille
pillow	hodepute
pilot	los
pincers	knipetang
pineapple, pine-apple	ananas
pink, pink	rosa
pipe, tube, channel	rør
piston	stempel
pitcher, jug, jar	krukke
plain, distinct, liquid, lucid, clear, limpid	klar
planets	planeter
plaster	plaster
platform, wharf	kai
platter, plate, course, dish	tallerken
please	vær så god
plug, spark plug	tennplugg
plum	plomme
plumber	rørlegger
pocket	lomme
poison	gift
police	politi
police-station	politistasjon
policeman	politikonstabel
poor	stakkars
poor, miserable	fattig
population	befolkning
pork	svinekjøtt
port, harbour	havn
portable	transportabel
porter	bybud
porter	bærer
porter	portier
Portuguese	Portugisisk
possibly, maybe, perhaps	kanskje
post office, post-office	postkontor
postcard	brevkort
postman	postbud
pot, jug	gryte
potato	potet
poverty	fattigdom
powder	pulver
powder, cosmetic powder	pudder
prescription, recipe	resept
present	presang
pressing, urgent	inntrengende
price, award	pris
prime minister	statsminister
print, duplicate	kopiere
printer	skriver
probably	muligens
probably, likely	sannsynligvis
prodigy	vidunder
profession	yrke
property, quality	kvalitet
provider	leverandør
public enemy	samfunnsfiende
pudding	pudding
pulse	puls
pump	pumpe
purchase, buy	kjøpe
purple	purpur
purpose, goal, measure, measurement, gauge	mål
purse, wallet	pengepung
purse, wallet	pung
quack	kvaksalver
quack	snadring
quadrangular	firkantet
quail	bli redd
quail	vaktel
quaint	eiendommelig
quaint	underlig
quake, quaver, quiver	skjelve
qualification	forutsetning
qualification	kvalifikasjon
qualify	kvalifisere
qualify	modifisere
qualitative	kvalitativ
quality	egenskap
qualms	betenkeligheter
qualms	skrupler
quantity	kvantitet
quantity, crowd	mengde
quarantine	karantene
quarrel	krangel
quarrel	krangle
quarrel	trette
quarrelsome	kranglesyk
quarry	bryte stein
quarry	jaktbytte
quarry	steinbrudd
quarter	fjærdedel
quarter	kvartal
quarter	kvarter
quaver	åttendedelsnote
quaver, quake, quiver	skjelving
queazy	kvalm
queen	dronning
queer	homofil
queer	rar
quell	undertrykke
quench	slukke
quench	slå ned
querulous	klagende
quest	leting
question, issue	spørsmål
questioning	avhør
questionnaire	spørreskjema
quibble	krangle om detaljer
quibble	liten uenighet
quibbling	ordkløveri
quickly, swiftly, jaunty	kvikk
quickness	raskhet
quickwitted	slagferdig
quickwitted	snartenkt
quid	pund
quiet	stillhet
quiet, silent	stille
quieten	berolige
quieten	roe ned
quilt	lappeteppe
quilt	vatteppe
quilted	vattert
quinine	kinin
quirk	særhet
quirk, caprice, freak	lune
quite	javisst
quite, altogether	ganske
quits	kvitt
quits	skuls
quiver	kogger
quiver, quaver	vibrere
quizzical	ertende
quota	andel
quota	kvote
quotation	notering
quotation	sitat
quotationmark	anførselstegn
quote	notere
quote	sitere
rabbit	kanin
radio	radio
railway platform, wharf, platform	perrong
rain	regn
raincoat	regnfrakke
raspberry	bringebær
rat	rotte
razor	barberkniv
razor-blade	barberblad
read	lese
realize, get, grasp, figure out, gather, realise	forstå
rear wheel, back wheel, hind wheel	bakhjul
rear-light, rear-lamp, tail-light	baklys
receipt	kvittering
receive, take in, take, accept	godta
recent, well, fresh, good	frisk
recieve	motta
reciever	mottaker
record-player	platespiller
red, red	rød
reek, smell, give off an odour	lukte
register, record	innskrive
rejected	avslått
release, desert, abandon, forgive	forlate
religion	religion
remote, gaunt, lonely, immense, lonesome, dreary	ensom
rent money, rent, hire, lease	leie
repeat	gjenta
resist	motstå
resistance	motstand
resources, remedy, means, tool	middel
rest, repose	hvile
restaurant	restaurant
retardation, delay	forsinkelse
return-ticket	returbillett
revue, magazine, magazine, periodical, gazette	tidsskrift
rhythm	rytme
rice	ris
rifle, gun	gevær
right, to the right	til høyre
rim	felg
ring	ring
risk	risiko
river	elv
river	flod
road, way, route	vei
roast, toast, fry	steke
rod, pole	stang
roll	bolle
rolling-pin	kjevle
roof, hold	tak
root	rot
rope, string	tau
round, rope, string	reip
rubber, gum	gummi
run	løpe
rye	rug
sack, bag	sekk
sack, bag	veske
saddle, sitting-room, sitting room, parlour, hall	sal
safety-belt, lifebelt	livbelte
safety-pin, safety pin	sikkerhetsnål
sailor	sjømann
sallow, pale	blek
salmon	laks
salt	salt
sand	sand
satellite	satelitt
saturday	lørdag
sauce	saus
saucer	koppeskål
sausage	pølse
saw	sag
scar	arr
schedule, time-table	rutetabell
scholar, student	student
school, school	skole
science	vitenskap
scissors	saks
scold, reproach, rebuke, reprove	dadle
scrap, rag	klut
screw	skrue
screwdriver	skrujern
sea	hav
seagull, gull	måke
second	andre
see, call on, visit, attend	besøke
see, come across, encounter, meet	møte
self-esteem	selvtillit
sell, vend, dispose of	selge
sender	avsender
September	september
serpent, snake	orm
servant, maid	hushjelp
seven	sju
seventeen	sytten
seventh	syvende
seventy	sytti
sew	sy
sexual intercourse	samleie
shack, cottage, hut, cabin, lodge	hytte
shadow	skygge
share, part, piece	del
shark	hai
shave	barbere
shaving-brush	barberkost
shawl	sjal
shear, cliff, cut, clip, fleece	klippe
sheep	får
sheet	laken
sheet, leaves, leaf	blad
shifting spanner, monkey-wrench	skiftenøkkel
shirt	skjorte
shirt	trøye
shock-absorber	støtfjær
shoe	sko
shoemaker	skomaker
shop, store, boutique	butikk
short circuit	kortslutning
short, brief	kort
shotgun, hail	hagle
shoulder	skulder
shout, scream, cry out	skrike
shower	dusj
sick-note	sykemelding
sickleave	sykepermisjon
sight, view	utsikt
sign	signere
sign	skilt
signature	underskrift
signpost	veiviser
silk	silke
silver, silver	sølv
simplify	forenkle
since, because, for the reason that	fordi
sing	synge
sister	søster
sister-in-law	svigerinne
sit	sitte
sitting room, livingroom, sitting-room	dagligstue
six	seks
sixteen	seksten
sixth	sjette
sixty	seksti
skate	skøyte
skateboard	rullebrett
skeleton, framework, frame	skjelett
skeptic	skeptisk
ski	ski
skipping rope	hoppe tau
sky, heaven	himmel
sleep	søvn
sleeping-car	sovevogn
sleepingbag	sovepose
sleigh	slede
slender, thin, gaunt, lean	tynn
slow	langsom
slow train	somletog
small, young, diminutive	liten
smoke, fume	røyk
smokers	røyke-kupé
snack, lunch	lunsj
snifter, dram, snorter, peg, nip	dram
snow	sne
soap	såpe
society, association	forening
sock	sokk
sofa	sjeselong
sofa, couch	sofa
soft	bløt
soldier, pawn	soldat
solution	oppløsning
somber, miserable, dismal, bleak, sad, gaunt	sturen
son	sønn
soup	suppe
sour, acid, bitter, grumpy, crabby, tart	sur
south	syd
spare time, time off, holiday, vacation	ferie
spark	gnist
speak, talk	snakke
speak, talk	tale
speed	fart
speed-limit, speed limit	fartsgrense
spice	kryddek
spider	edderkopp
spinach	spinat
spread, smear, lubricate, anoint	smøre
spring, fountain, source, fountain	kilde
spring, springtime	vår
square, public square, spot, plaza, ground, place	plass
stab, sting, jab	stikke
stage	scene
stage, station, stop	stasjon
stairs, staircase	trappe
stamp, postage stamp	frimerke
stand, abide	stå
star, star	stjerne
stars	stjerner
starter	starter
station-master	stasjonmester
statue	statue
steak, beefsteak	biff
steal, lift	stjele
steamship	dampbåt
steel, steel	stål
stick, cane, baton	stokk
stone, stone, rock	stein
stone-chippings, broken stones, chippings, rubble	steinsprut
stop	holdeplass
stop	stoppested
storage battery, battery, accumulator	akkumulator
storm, tempest, gale	storm
strange, foreigner, alien, stranger	fremmed
strawberry	jordbær
stream	å
street	gate
streetcar, tram	trikk
stroll, walk	spasertur
strong	sterk
stumble, falter	snuble
sty, stall, stable	stall
subway, underground	undergrunnsbane
suck	suge
sufficient, enough	nok
sugar	sukker
sum, amount	beløp
summer	sommer
sun	sol
sun-glasses	solbriller
sunday	søndag
sunset	solnedgang
supper, evening meal	aftens
supply, hand, deliver	levere
surprise	overraske
swaddling cloth, diaper	bleie
sweater	genser
swift, fast, speedy, rapid	hurtig
swim	svømme
swimming trunks	badebukse
swimming-bath	svømmebad
swimming-bath	svømmeplass
switch	bryter
table	bord
tailor	skredder
take, occupy	besette
tank	tank
tardy	sen
taste, flavour	smak
taxi, cab	drosje
tea	te
teach, learn	lære
teeth	tenner
telegram	telegram
telephone	telefon
television, tv	fjernsyn
ten	ti
tendinous ligament	senebånd
tent	telt
tenth	tiende
test, attempt	prøve
thanks, thank you	takk
that, which, who, which one	hvem
theatre	teater
thermos bottle, thermos flask, thermos	termosflaske
they, them	de
thief	tyv
think	tenke
third	tredje
thirst	tørst
thirteen	tretten
thirty	tredve
thread	tråd
three, tree	tre
throat, gorge	strupe
thumb	tommelfinger
thunder	torden
thursday	torsdag
ticket-window, window, hatch	luke
tickle	kile
ticklish	kilen
tie, necktie	slips
tiger	tiger
time	tid
time, hour	time
time-table, schedule	timeplan
tin, glare, glance, look, tin can, can	blikk
tin-opener	hermetikkåpner
tip, gratuity	drikkepenger
tired	trøtt
to the left	til venstre
to-day, today	i dag
tobacco	tobakk
toe	tå
toenail	tånegl
together	sammen
toilet	WC
toilet, lavatory, loo	toalett
toilet-paper	toalett-papir
tomato	tomat
tomato juice	tomato
tomato-soup	tomatsuppe
tomorrow	i morgen
tongs	tange
tongue, language	språk
tongue, sole	tunge
tonight	i natt
tooth, tooth	tann
tooth-brush	tannbørste
tooth-paste	tannkrem
tourist agency, travel agency	reisebyrå
towel	håndkle
tower	tårn
towing-line	slepetau
townhall, town hall, city hall, town-hall	rådhus
toy	leketøy
traffic	trafikk
train	tog
tram, streetcar	sporvogn
transfusion	overføring
translate	oversette
transmit, send	sende
transparant, limpid	gjennomsiktig
travel, ride, go	kjøre
trip, travel, voyage, erect, journey, leave	reise
trousers, pants	bukser
true	sann
trunk	kuffert
truth, truth, reality	sannhet
tube, valve	ventil
tuesday	tirsdag
tulip	tulipan
turkey	kalkun
turn off	slå av
turnpike, super highway, motor road, motorway	autobane
twelve	tolv
twenty	tjue
twenty	tyve
two	to
typewriter	skrivemaskin
uglyness	styggedom
umbrella	paraply
uncle	onkel
unconscious	bevisstløs
undergarment	underkjole
underground, subway	undergrunn
underneath, below, down	ned
underpants, panties	underbukse
unleaded	blyfri
until, into, for	til
upset, turn over, overthrow, capsize, turn	kantre
upstairs, on top, overhead, above	oppe
upwards, here, up	hit
vacant	vakant
vacant, unoccupied, disengaged, free	ledig
vaccine	vaksinasjon
valid, good	gyldig
valley	dal
vanity bag, lady's bag	dameveske
veal	kalvekjøtt
vegetable	grønsak
velvet	fløyel
venerical	venerisk
very much, very	meget
victim	offer
videotape	videobånd
village	bygd
village	landsby
vinegar	eddik
violence, contravention, infringement	overtredelse
violet	fiolett
violin	fiolin
visit	visitt
vocabulary	vokabular
vocabulary, dictionary	ordbok
waiter	kelner
waiting-room	venterom
wake	våkne
wake up	vekke opp
wake up	våkne opp
wake, arouse, awaken	vekke
wall	vegg
wallet, stock exchange, purse	børs
wallpaper	tapet
war	krig
wardrobe	garderobe
warehouse	varehus
wash	vaske
water, lotion	vann
water-bottle, flask, canteen	feltflaske
way out, exit	utgang
way, custom	bruk
wealthy, well-off, rich	rik
weather	væer
wedding, wedding-party	bryllup
wednesday	onsdag
week	uke
weight	vekt
west, vest, waistcoat, west	vest
wet	våt
whale	hval
what for, why	hvorfor
wheat	hvete
wheel	hjul
where	hvor
whipped cream	fløtekrem
whisk	visp
white, white, blank	hvit
wind	vind
window	vindu
wine	vin
wing	vinge
wingnut	vingemutter
winter	vinter
with	med
woman, female	kvinne
women	kvinner
wood, in, about, timber, at	ved
woods, forest, forest	skog
wool, fleece	ull
word	ord
work out, calculate	regne
world, earth, world	verden
worth, value	verdi
wrench, key	nøkkel
wrist-watch, watch	armbåndsur
write, type	skrive
wrong, erroneous, mistaken	urett
x-ray	røntgen
xenophobia	fremmedhat
yacht	lystbåt
yacht	yacht
yachting	seiling
yap	gneldre
yard	yard
yarn, fairytale	skrøne
yarnreel	garnvinde
yawn	gjesp
yawn	gjespe
year	år
yearly, annual	årlig
yeast	gjær
yell, howl	hyl
yell, howl	hyle
yellow	gul
yellowish	gulaktig
yelp, bark, yap	bjeff
yelp, bark, yap	bjeffe
yes	ja
yesterday	i går
yet	dog
yet	enda
yet	ennå
yet	likevel
yew	barlind
yield	utbytte
yield	yte
yield	ytelse
yoke	forspann
yoke	spenne i åk
yoke	åk
yolk	eggeplomme
yonder, there	der
you	De
you	deg
you	Dem
you	dere
you	du
you	man
young	ung
your	dine
your	ditt
your, yours	deres
your, yours	din
yourself	de selv
yourself	du selv
yourselves	Dem selv
yourselves	dere selv
youth hostel	vandrerhjem
youth, juvenile	ungdom
zealot	svermer
zealous	nidkjær
zebra	sebra
zest	behag
zest	krydder
zipper	glidelås
zither	sitar
zodiac	dyrekretsen
zone	sone
zoologist	zoolog
zoology	zoologi
