a	primeira letra do alfabeto
a	um
a	uma
a lot of, much, very	muito
a, any, anybody, some, somebody, someone	alguém
a, in, inside, into, per, within, at, in-, on	em
aardvark	oricterope
aardvark	porco-da-terra
aardvarks	oricterope
aardvarks	porco-da-terra
aback	atrás
aback	detrás
aback	para trás
aback	por trás
aback	às avessas
abacus	ábaco
abaft	à popa
abaft	à ré
abalone	abalone
abalone	molusco da califórnia
abalones	abalones
abandon	abandonar
abandon	abandono
abandon	deixar
abandoned	abandonado
abandoned	abandonado
abandoned	dissoluto
abandoned	imoral
abandonee	abandonado
abandoner	abandonador
abandoning	abandonando
abandonment	abandonamento
abandonment	abandono
abandonment	abandono
abandonment	desamparo
abandonment	renúcia
abandonments	abandonamentos
abandons	abandonos
abase	humilhar
abase	rebaixar
abase	rebaixe
abased	abater
abased	humilhado
abased	rebaixado
abasement	humilhação
abasement	rebaixamento
abash	confundir
abash	embaraçar
abash	envergonhar
abash	humilhar
abash, confuse	confunda
abashed	confuso
abashed	embaraçado
abashed	envergonhado
abashed, mistaken	confundido
abashes	embaraça
abashing	embaraço
abashment	embaraço
abasing	humilhação
abate	abater
abate	amainar
abate	diminuir
abate	enfraquecer
abate, diminish, lessen	diminua
abated	enfraquecido
abatement	enfraquecimento
abatements	enfraquecimentos
abates	decrescer
abates	enfraquecer
abating	decrescendo
abating	enfraquecendo
abattoir	matadouro
abbacy	abadia
abbe	abade
abberations	aberração
abbey	abadia
abbeys	abadias
abbot	abade
abbot	abade
abbot	padre
abbots	abades
abbreviate	abreviar
abbreviate	abrevíe
abbreviated	abreviado
abbreviates	abrevia
abbreviates	amor
abbreviating	abreviando
abbreviation	abreviatura
abbreviation	abreviatura
abbreviation	abreviação
abbreviations	abreviação
abbreviator	abreviador
abc	abecedário
abc	o alfabeto
abc	á-bê-cê
abdicable	abdicável
abdicate	abdicar
abdicated	abdicado
abdication	abdicação
abdicator	abdicante
abdomen	abdomen
abdomen	abdômen
abdomen, belly, tummy	ventre
abdomens	abdomens
abdominally	abdominalmente
abduce	desviar
abduce	separar
abduced	desviado
abduced	separado
abducens	abducente
abducent	abducente
abducentes	abducents
abducing	abduzindo
abduct	sequestrar
abduct	sequestre
abducted	raptado
abducting	raptando
abduction	rapto
abductions	raptos
abductor	raptor
abductors	raptores
abducts	rapta
abeam	através
abecedarian	abecedário
abed	na cama
aberrance	aberração
aberrance	caminho
aberrancy	aberração
aberrant	aberrante
aberrantly	aberrantemente
aberration	ABERRAÇÃO
aberration	aberração
aberration, error, mistake	defeito
aberration, error, mistake, bug, wrong	erro
abet	instigar
abet, aid, assist, help	ajudar
abetment	instigação
abets	instiga
abetted	instigado
abetter	instigador
abetter, abettor, accomplice	cúmplice
abetting	instigando
abettor	cúmplice
abettor	instigador
abeyance	suspensão
abhor	abominar
abhorrence	aversão
abhorrent	repugnante
abhorrently	odiosamente
abhorrer	pessoa odienta
abhors	abomináveis
abidance	permanência
abide	agu.entar
abide	conformar-se
abide, bear, endure, put up with	padecer
abide, expect, wait, await, wait for	esperar
abiding	continuação
abidingly	permanentemente
abilities	habilidades
ability	abilidade
ability	habilidade
abiogenesis	abiogénese
abiogenetic	abiogenético
abiological	abiológico
abiologically	abiologicamente
abiotic	abiotico
abject	abjecto
abjection	abjecção
abjections	abjecção
abjectly	abjectamente
abjectness	degradação
abjectness	vileza
abjuration	abjuração
abjure	abjurar
abjure	apostatar
abjure	renunciar
abjurer	abjurante
abjurer	apóstata
abjures	abjura
ablation	ablação
ablative	ablativo
ablaut	mudançã da vogal no radical duma palavra
ablaze	chamejante
ablaze	flamejante
able	hábil
able, capable	capaz
able-bodied	são
abloom	florescente
ablution	ablução
ablutionary	detersivo
ablutions	ablução
ably	hábilmente
abnegate	abjurar
abnegate	abnegar
abnegate	abnegue
abnegate	renunciar
abnegates	abnega
abnegation	abnegação
abnegator	abjurador
abnegator	apóstata
abnormal	anormal
abnormal	anormal
abnormal	anômalo
abnormal	incomum
abnormalities	anormalidades
abnormality	anormalidade
abnormalize	anormalizar
abnormalizes	anormaliza
abnormally	anormalmente
aboard	a bordo
aboard	a bordo de
abode	domicílio
abode	lar
abode, accommodation, dwelling	aposento
abodes	residências
aboil	abolir
abolish	abolir
abolishable	abolível
abolishable	anulável
abolishable	cancelável
abolishable	revogável
abolished	abolido
abolished	anulado
abolished	cancelado
abolished	revogado
abolisher	revogador
abolishers	revogadores
abolishes	anula
abolishes	cancela
abolishes	revoga
abolishing	abolindo
abolishment	abolição
abolition	abolição
abolitionism	abolicionismo
abolitionist	abolicionista
abolitionists	abolicionistas
abominable	abominável
abominable	execrável
abominably	abominavelmente
abominably	execravelmente
abominate	abominar
abominate	execrar
abomination	abominação
abomination	execração
abominations	abominação
abominations	execração
aboriginal	aboriginal
aboriginally	originariamente
aboriginally	primitivamente
aborigine	aborígene
aborigines	aborigenes
aborigines	primitivos habitantes de um pais
abort	abortar
abort	aborto
aborted	cancelado
aborter	aborteiro
abortifacient	abortivo
aborting	abortando
abortion	aborto
abortions	abortos
abortive	fracassado
abortively	abortivamente
abortiveness	aborto
abortiveness	fracasso
abound	abundar
abounding	abundáncia
abounds	abunda
about	aproximadamente
about, approximately, corral, fence	cerca
about-face	meia volta
above	acima de
above	fora de
above	na parte superior
above	por cima
above	sobre
above all, especially, chiefly, mainly	principalmente
above all, especially, overcoat	sobretudo
above, on top, overhead, upstairs	acima
above, over, about, over-	sobre
above-board	acima-placa
above-mentioned	acima mencionado
aboveground	superficial
abovementioned	supramencionado
abracadabra	amuleto
abrade	desgastar
abrade	esfragar
abrade	raspar
abrade	safar
abrasion	abrasão
abrasion	desgaste
abrasion	fricção
abrasion	raspadura
abrasions	desgastes
abrasions	fricções
abrasions	raspaduras
abrasive	abrasivo
abrasive	abrasões
abrasively	abrasivamente
abrasiveness	abrasividade
abrasives	abrasivos
abreast	de frente
abreast	lado a lado
abreast	ombro com ombro
abridge	abreviar
abridge	encurtar
abridge	reduzir
abridge	resumir
abridged	abreviado
abridged	resumido
abridgement	redução
abridgement	resumo
abridgement	sumário
abridgment	privação
abridgment	redução
abridgment	resumo
abridgment	sumário
abroach	em bica
abroach	profusamente
abroad	estrangeiro
abroad	fora
abroad	no exterior
abrogate	abrogar
abrogate	revogue
abrogated	abrogado
abrogates	abroga
abrogating	abrogando
abrupt	abrupto
abrupt	abrupto
abruption	interrupção brusca
abruptly	abruptamente
abruptly	bruscamente
abruptness	aspereza
abruptness	brusquidão
abruptness	indelicadeza
abruptness	rudeza
abscess	abcesso
abscess	apostema
abscissa	abscissa
abscond	esconder
abscond	evada-se
abscond	evadir
abscond	fugir à ação da justiça
absconder	desertor
absconder	foragido
absconder	fugitivo
absence	afastamento
absence	ausência
absence	ausência
absence	carência
absence	falta
absence	inatenção
absences	ausencias
absent	ausente
absent	ausente
absent onself, depart, go away, leave	afastar-se
absent-minded	distraído
absented	ausente
absentee	absentista
absentee	ausente
absenteeism	absentismo
absentminded	distraido
absentmindedly	distraidamente
absinth	absinto
absinthe	absinto
absolute	absoluto
absolute	absoluto
absolutely	absolutamente
absolutely	absolutamente
absolutely, genuinly, indeed, really	deveras
absolutely, genuinly, indeed, really, truly	verdadeiramente
absolutes	absolutos
absolutism	absolutismo
absolutist	absolutista
absolve	absolver
absorb	absorva
absorb	absorver
absorbed	absorto
absorbent	absorvente
absorbent	absorvente
absorber	absorvente
absorbing	absorver
absorption	absorção
abstain	abster-se
abstemious	abstêmio
abstention	abstenção
abstinence	abstinência
abstinent	abstinente
abstract	abstracto
abstract, brief, briefs, digest, summary	sumário
abstracted	abstraído
abstraction	abstração
abstraction, theft	furto
abstractionism	abstracionismo
abstractionist	abstracionista
abstractly	abstratamente
abstruse	abstruso
absurd	absurdo
absurdity	absurdo
absurdly	absurdamente
abundance	abundáncia
abundance	abundância
abundant	abundante
abundant, abundantly	abundante
abuse	abuso
abuse	abuso
abused	abusado
abuser	abusador
abusers	abusadores
abuses	abusa
abusive	abusivo
abusively	abusivamente
abusiveness	abusividade
abutment, boundary, limit	limite
abyss	abismo
abyssal	abissal
acacia	acácia
academia	academia
academic	acadêmico
academic, scholar, student	estudante
academically	academicamente
academician	acadêmico
academicism	academicismo
academy	academia
accede	aceder
accede	asquiecer
accede	consinta
accede, agree, consent	concordar
accelerate	acelerar
accelerate	acelere
accelerates	acelera
acceleration	aceleração
accelerator	acelerador
accelerators	aceleradores
accent	acento
accent	acento
accent	acentuar
accent	sotaque
accent, emphasis	ênfase
accented	acentuado
accentuate	acentuar
accentuate	salientar
accentuated	acentuado
accentuates	acentua
accentuating	acentuando
accept	aceitar
accept	aceite
accept	admitir
accept, receive, take, take in	aceitar
acceptable	aceitável
acceptable	aceitável
acceptableness	aceitabilidade
acceptance	aceitação
acceptance	aceitação
acceptances	aceitação
accepted	aceitado
acceptor	aceitador
access	acesso
access	acesso
access	ataque
access, attack	ataque
accessible	acessível
accessible, handy	acessível
accession, rise	ascensão
accessories	acessórios
accessory	acessórios
accessory	auxiliar
accessory, attachment	acessório
accident	acidente
accident	acidente
accident-prone	acidente-accident-prone
accidental	acidental
acclimatize	aclimate
acclimatize	aclimatizar
accommodate, accomodate	acomode
accommodating	acomodar
accommodation, accomodation	acomodação
accompanier	acompanhante
accompaniment	acompanhamento
accompany	acompanhe
accompany, accompanying	acompanhar
accomplish, realise	realize
accord, agreement	acordo
accordance	acordo
accordances	acordos
accordingly	de acordo
accordion	acordeon
accordion	acordeão
account, client, customer	cliente
accountant	contabilista
accredit, believe	acredite
accumulate	acumule
accumulator	acumulador
accuracy	exatidão
accurate, exact	exato
accuse	acuse
accuse, blame	culpar
accused	acusado
accustom	acostume
acetate	acetato
acetone	acetona
acetylene	acetileno
achieve	consiga
acid	ácido
ack-ack	ack-ack-ack
acknowledge, recognise, recognize	reconheça
acknowledgement	reconhecimento
acorn	bolota
acoustic	acústico
acoustics	acústica
acquire	adquira
acquire, attain, get, obtain	adquirir
acquire, attain, get, obtain	obter
acquired	adquirido
acquisition	aquisição
acronym	acrônimo
across	através de
across from, against, in exchange for	contra
act	ato
act, do, make, perform, making	fazer
action	ação
action	ação
action, activity	accão
action, activity	acão
action, exploit	façanha
actions	ação
active	ativo
activist	activista
activity	atividade
actor	actor
actor	ator
actress	actriz
actress	atriz
actual, royal	real
actually, really	realmente
actuary	actuário
acute, shrill	agudo
ad, advertisement, announcement	anúncio
adapt	adapte
adaptation	adaptação
adapted	adaptado
adapter, adaptor	adaptador
add	adicione
addition	adição
additional	adicional
address	endereço
addressing-machine	addressing-máquina
adept, expert	perito
adequate	adequado
adherents	aderente
adhesion	adesão
adieu, farewell, bye, goodbye	adeus
adjacent	adjacente
adjectival	adjetival
adjective	adjetivo
adjoin	seja contíguo com
adjust, adjustment, fit, setting	ajuste
adjusted	ajustado
administer	administre
administration	administração
administrative	administrativo
administrator	administrador
admiral	almirante
admire, admiring	admirar
admirer	admirador
admit	admita
ado, din, noise	ruído
adopt	adoptar
adopt	adote
adopted	adotado
adrenaline	adrenalina
Adriatic	O Adriático
adult	adulto
advance	avanço
advantage	vantagem
advantageous	vantajoso
adventure	aventura
adverb	advérbio
adversary	adversário
advertise, announce	anuncie
advertisement	propaganda
advice, counsel, council	conselho
advisable	aconselhável
advise, counsel	aconselhar
advise, recommend	recomende
advocate, lawyer	advogado
aerate, ventilate	ventile
affair, business, business deal, case, subject	assunto
affair, case	caso
affect	afete
affected	afetado
affection	afeição
affiliate, branch	filial
affinity	afinidade
Afghanistan	Afeganistão
afraid	receoso
Africa	África
African	Africano
after	depois
after, next	em seguida
after-treatment	tratamento posterior
afternoon, late, tardy	tarde
afterwards, later	mais tarde
again	outra vez
against	de encontro
agar	ágar
agar-agar	ágar-ágar
age	idade
aged	envelhecido
agency	agência
agenda	agendas
agent	agente
agglomerate	aglomerado
aggregate	agregado
aggressor	agressor
agitate, stir	agite
agitated	agitado
agony	agonia
agree	concorde
agreed	concordado
agriculture	agricultura
agriculturist	agricultor
ahead, foreward	adiante
ahead, formerly, previously	diante
ahead, formerly, previously, before	antes
aide-de-camp	aide-de-acampamento
aim, goal, purpose	alvo
air	ar
air-balloon	ar-balão
air-conditioning	condicionamento de ar
air-cushion	ar-coxim
air-defence	ar-defesa
air-filter	ar-filtro
air-fleet	ar-frota
air-grid	ar-grade
air-gun	ar-injetor
air-mail	correio aéreo
air-pocket	ar-bolso
air-pollution	poluição atmosférica
air-resistance	ar-resistência
air-ship	dirigível
air-squadron	ar-esquadrão
air-valve	ar-válvula
airfield	aeródromo
airline-pilot	linha-piloto
airport	aeroporto
alarm	alarme
alarm clock	despertador
Albania	Albânia
alcohol	álcool
alcoholic	alcoólico
alderman	vereador
ale	cerveja inglêsa
ale, beer	cerveja
alert, prompt	alerta
algebra	álgebra
Algeria	Algéria
Algeria	Argélia
Algiers	Argel
algorithm	algoritmo
alien, foreigner	estrangeiro
alive, brisk, live	vivo
all of a sudden, suddenly	subitamente
all, each, every, everyone	todo
allegedly	alegada
alley	aléia
alley, lane	beco
alligator	jacaré
allot	distriba
allow	reserve
alloy, combine, league	liga
alluring, fascinating	fascinar
almond	amêndoa
almost, nearly	quase
alone	sozinho
along	ao longo
alongside, beside	ao lado de
alphabet	alfabeto
Alps, alp	alpes
already, by now, yet	já
Alsace	Alsácia
Alsace-Lorraine	Alsácia-Lorena
also	também
also, too	tambén
alter	altere
alternate, substitution	substituição
alternating	alternar
alternative	alternativa
altitude, height	altitude
altitude, height	altura
altogether, everything, all	tudo
aluminium, aluminum	alumínio
always, ever	sempre
amateur	amador
amaze	espante
amazing	espantar-se
Amazon	Amazonas
ambassador	embaixador
ambition	ambição
ambitious	ambicioso
ambulance	ambulância
America	América
American	Americano
ammunition	munição
among, between, amidst, enter	entre
amount	uma quantidade
ampere	ampère
amputate	ampute
Amsterdam	Amsterdão
amuse	diverta
amusement, fun	divertimento
amusing	divertir
analyse, analyze	analise
analysis	análise
analytic, analytical	analítico
anchor	escora
anchor	âncora
anchovy	anchova
ancient, antique	antigo
and	e
angel	anjo
anger	raiva
angle	ângulo
angry	irritado
animal	animal
Ankara	Ancara
ankle	tornozelo
annotation	anotação
announcer	anunciador
annoy	irrite
annual	anual
another	outros
answer, reply	resposta
answer, reply, respond	responder
ant	formiga
antelope	antílope
antenna	antena
anthropologist	antropólogo
anti-freeze	anticongelante
anticipate	antecipe
Antilles	Antilhas
Antwerp	Antuérpia
anvil	batente
anxious	ansioso
anxiously	ansiosamente
any	quemquer
any, some	alguns
anybody	qualquer um
anything	qualquer coisa
anything, something	algo
anywhere	em qualquer lugar
apart, distant, far	distante
apartment	apartamento
ape-like, monkey-like	macaco-como
aperture, opening, gap	abertura
apologize	desculpe-se
apology, satisfaction	satisfação
apostrophe	apóstrofe
apparatus, device, set	aparelho
apparatus, instrument	instrumento
apparent	aparente
apparently	aparentemente
apparently, obviously	evidentemente
appeal	apelação
appear	apareça
appear, emerge, perform	aparecer
appearance	aparência
appellation, name	nome
appendix	apêndice
appetite	apetite
applaud	aplauda
apple	maçã
apple	maçã
apple-tree	macieira
apple-tree	maçã-árvore
apples	maçãs
applicable	aplicável
applicant	pretendente
application	aplicação
apply	aplique
appoint	aponte
appointment	nomeação
appraise, estimate, rate	avaliar
appraise, estimate, rate	orçar
appraiser	avaliador
appreciate	aprecie
approach	aproximação
appropriate, proper, suitable	apropriado
appropriately	apropriadamente
approval	aprovaçã0
approve	aprove
approximate	aproxime
approximately	aproximadamente
apricot	alperce
apricot, Damascus	Damasco
April	Abril
apron	avental
aptitude, fitness	aptidão
aquarium	aquário
aquatic	aquático
Arab, Arabic	Árabe
arabesque	arabesco
Arabia	Arábia
arable	arável
arachnoid	aranha
arbiter, arbitrator, umpire	árbitro
arbitral	arbitral
arbitrarily	arbitrariamente
arbitrary	arbitrário
arbor, chuck	mandril
arc	arco
arc, arch-	arco
arcade	arcada
arcane	arcano
arch	arco
arch-enemy	arco-inimigo
archaic	arcaico
archaism	arcaísmo
archdioceses	arquedioceses
archducal	arqueducal
archeologist	arqueologista
archipelago	arquipélago
architect	arquiteto
archive	arquivo
archives	arquivos
Arctic	Ártico
are, be	seja
area	área
Argentina, Argentine	Argentina
Argentine	argentino
argue, discuss	discuta
arise	levante-se
arise, be born	nascer
arithmetic	aritmética
arm	braço
arm-chair, armchair	poltrona
Armenia	Arménia
army	exército
around	em torno
arouse	desperte
arrange	arranje
arrange, fix up	arranjar
arrangement	arranjo
arrears	atrasos
arrest	apreensão
arrival	chegada
arrivals	chegadas
arrive	chegue
arrogant	arrogante
arrow	seta
art	arte
art	arte
artery	artéria
artery	artéria
artichoke	alcachofra
article	artigo
article, item	artigo
article, object, thing	objecto
artillery	artilharia
artist	artista
artistic	artístico
as, how, like, such as	como
as, how, like, such as	quão
ascertain, verify	verifique
ash	freixo
ash, cinder	cinza
ash-tray	cinzeiro
Asia	Ásia
Asian	asiático
ask	perguntar
ask, ask for, beg, bid, request	rogar
ask, borrow	peça
asparagus	espargo
asparagus	espargos
aspect	aspecto
aspen	álamo tremedor
asphalt	asfalto
aspirin	aspirina
ass, donkey	burro
assailant, burglar	assaltante
assault	assalto
assemble, hill	monte
assembler	ajuntador
assembly, cluster	conjunto
assert	afirme
assessment	avaliação
asset	recurso
assets, resources	recursos
assign	atribua
assist	assistência
assistant, attendant	assistente
associate	associado
association	associação
Assumption, guess	Suposição
assure	assegure
asterisk	asterisco
astronaut	astronauta
astronomer	astrónomo
astronomy	astronomia
Asturias	A Astúrias
at last, finally, ultimately	finalmente
at once, instantly, immediately	directamente
at present, now	agora
at present, now	ora
Athens	Atenas
athlete	atleta
athletic	atlético
Atlantic, Atlantic Ocean	Atlântico
atmosphere	atmosfera
atom	átomo
atomic	atômico
attach	anexo
attack	ataque
attacker	atacante
attain, overtake, reach	alcance
attempt, test, effort, endeavour, struggle	esforço
attempt, test, try	provar
attempt, try	tentativa
attend	atenda
attention	atenção
attenuate	atenue
attest	ateste
Attic	Sótão
attitude	atitude
attract	atraia
attraction	atração
attractive	atrativo
attribute	atributo
aubergine	beringela
aubergine	berinjela
audience	audiências
auditor	revisor de contas
augment	aumente
August	Agosto
aunt	tia
Australia	Austrália
Austria	Áustria
Austrian	austríaco
author	autor
authority	autoridade
authorization, warrant	autorização
authorize	autorize
automatic	automático
autonomous	autônomo
autumn	outono
available	disponível
avenue	avenida
average	média
aviation	aviação
aviator	aviador
avoid	evite
avoid, evade	evitar
await, expect	espere
awake	acorde
aware	ciente
awareness	consciência
away	afastado
away	longe
awful, dreadful, terrible	terrível
awkward	inábil
axe	Machado
axe	machado
axis	linha central
axis, axle, shaft, spindle	eixo
Azores	Açores
babble	balbuciar
babble	balbucio
babble	fala confusa
babble	falatório
babble	ruído
babble	tagarelar
babble	tagarelice
babbled	comentado
babbled	falado
babbled	murmurado
babe	meu bem
babe	querida
babes	gajas
babies	bebês
babies	nenens
baboon	babuíno
baboon	babuíno
babushka	avó
babushka	vovó
baby	bebe
baby	bebê
baby	nenen
babyhood	primeira infáncia
babyish	infantil
babysitter	baby-sitter
babysitter	babá
babysitters	babás
babysitting	pagear tomar conta de criança
baccalaureate	bacharelado
baccarat	bacará
bacchanal	bacanal
bachelor	bacharel
bachelor	solteiro
bachelorhood	celibato
bachelors	bacharéis
bachelors	celibatários
bachelors	solteiros
bacillar	bacilar
bacillary	bacilariáceo
bacilli	bacilos
bacillus	bacilo
back	costas
back	dorso
back	dorso
back, backside, rear	parte traseira
backache	dor de costas
backache	dor lombar
backaches	dores de costas
backaches	dores lombares
backbite	caluniar
backbite	dizer mal
backbite	falar pelas costas
backbiter	caluniador
backbiter	difamador
backbone	espinha dorsal
backbone	oluna vertebral
backbones	colunas vertebrais
backbones	espinhas dorsais
backcountry	o interior
backdrop	pano de fundo
backdrops	panos de fundo
backer	financiador
backer	patrocinador
backers	financiadores
backers	patrocinadores
backgammon	gamão
background	conhecimentos
background	formação
background	fundo de cenas
background	segundo plano
backhand	costas da mão
backhanded	ed
backlash	recuo
backless	sem retorno
backless	sem volta
backlog	acúmulo
backlog	reserva
backlogs	acúmulos
backlogs	reservas
backpack	mochila
backpacks	mochilas
backseat	banco de trás
backside	bunda
backside	nádegas
backside	parte traseira
backslide	reincidir
backslider	reincidente
backspace	retrocesso
backstage	camarim
backstairs	escada de serviço
backstitch	pesponto
backstop	batente
backup	apoio
backup	cópia
backups	cópias
backward	atrasado
backward	em decadência
backward	para trás
backward	retrógrado
backward, backwards	para trás
backwater	remanso
backwater	água parada
backwoods	região remota
backwoods	roça
backwoods	sertão
backyard	quintal
backyards	quintas
bacon	bacon
bacon	toicinho
bacon	toicinho
bacon	toucinho
bacteria	bactérias
bacterial	bacteriano
bacterium	bactéria
bacterium	bactéria
bad	mau
bad	ruim
bad, miserable, nasty, poor	mau
bad-smelling	mau-bad-smelling
bade	ofereceu
badge	distintivo
badge	emblema
badge	insígnia
badge, emblem	emblema
badger	texugo
badger	texugo
badly	gravemente
badly	incorretamente
badly	mal
badly, barely, hardly, scarcely	mal
badmen	bandidos
badmen	homens maus
baffle	confundir
baffle	contratempo
baffle	deixar perplexo
baffle	placa defletora
baffle	sonoflector
baffled	confundido
baffling	desconcertante
baffling	desnorteante
bag	bolsa
bag	mala
bag	maleta
bag	mochila
bag	saca
bag	saco
bag	saco
bag	sacola
bagatelle	bagatela
bagatelles	bagatelas
baggage	bagagem
baggage	equipamento
baggage, luggage	bagagem
baggageman	bagageiro
baggageman	carregador
baggagemen	carregadores
bagged	ensacado
bagger	ensacar
bagger	por na bolsa
baggers	ensacadores
Baghdad	Bagdade
bagpipe	gaita de foles
bagpiper	gaiteiro
bagpiper	tocador de gaita de foles
bagpipes	gaitas de foles
bags	malas
bags	mochilas
bags	sacas
bags	sacolas
bags	sacos
baguette	bisnaga
bail	caução
bail	fiança
bail	por em liberdade sob fiança
bailiff	alguazil
bailiff	bailio
bailiff	meirinho
bailiffs	meirinho
bailiffs	oficial de diligências
bailiwick	bailiado
bailiwick	distrito
bait	atrair
bait	engodo
bait	irritar
bait	isca
baize	baeta
bake	coza
bake	cozer no forno
baked	assado
baked	cozido
baker	padeiro
baker	padeiro
bakeries	padarias
bakers	padeiros
bakery	padaria
bakery	padaria
balance	contrapeso
balance	equilíbrio
balance	estabilidade
balance	ponderação
balance	saldo
balcony	balcão
balcony	balcão
balcony	sacada
bald	calvo
bald	sem vegetação
baldness	calvície
bale	fardo
baleful	funesto
baleful	maligno
balk	falhar
balk	frustrar
balk	impedir
balk	perder
Balkans	Balcãs
balky	birrento
balky	empacador
ball	bola
ball, sphere	esfera
ballast	reator
balloon	balão
balls	bolas
Baltic Sea, Baltic	Báltico
bamboo	bambu
banana	banana
banana-plant	banana-planta
bananas	bananas
band	faixa
bandit	bandido
bang	estrondo
Bangkok	Banguecoque
bank	banco
bank, bench	banco
bank, border, edge, shore, margin, rand	margem
bank-note, banknote	nota de banco
bankrupt	falido
banner, flag	bandeira
banquet-room	banquet-quarto
baptism	batismo
baptismal	batismal
baptisms	batismos
baptists	batistas
baptize	batisar
baptized	batisado
baptizing	batisando
bar	barra
barbecue	churrasco
barbed-wire	arame farpado
barber	barbeiro
barber, hairdresser	cabeleireiro
bare	desencapado
bare, naked, nude	nu
barely, hardly, only just, scarcely, just	apenas
bargain, business, deal	negócio
barge	barca
barge-master	barca-mestre
bark, peel	casca
barley	cevada
barn, shed, stand	celeiro
barometer	barómetro
barracks	quartel
barrel	tambor
barrier	barreira
bartender	bárman
Basel	Basileia
basement, cellar	cave
basement, cellar	subsolo
basic	básico
basic	básico
basin, bowl, pelvis	bacia
basin, bowl, pelvis	tejela
basis	base
basket	cesta
basket	cesto
bat, cane	bastão
bath	banho
bath	banho
bathe	banhar
bathe	banhe
bathe, have a bath	banhar-se
bathing-suit	bathing-terno
bathroom	banheiro
baton, cane, stick	vara
battery	bateria
battle	batalha
bay	baía
bayonet	baioneta
be	estar
be	ser
be afraid of, fear	recear
be afraid of, fear	temer
be alive, live	viver
be asleep, sleep	dormir
be lacking, be missing	faltar
be quiet	calar-se
beach	praia
bead	grânulo
beak, bill	bico
beam	feixe
bean	fava
bear	urso
beard	barba
bearing	rolamento
beast	besta
beat, hit, slap, strike	batida
beat, hit, strike	bater
beautiful	bonito
beautiful, fine, handsome, lovely	belo
beautiful, fine, handsome, lovely	formoso
beautifully	belamente
beauty	beleza
beaver	castor
because, for the reason that, why	porque
become	tornado
become, come about, grow, happen	acontecer
becoming	tornar-se
bed	cama
bee	abelha
bee-keeper	apicultor
beech	faia
beet	beterraba
beetle	besouro
beg	implore
beggar	mendigo
beggar	pedinte
begin, commence, get	comece
begin, commence, start	começar
begin, commence, start	iniciar
beginner, initiate	novato
beginning, commencement, start	começo
beginning, commencement, start, principle	princípio
behave	comporte-se
behaviour, conduct, deportment	conduta
behaviour, deportment	comportamento
behind	atrás de
behind, after	trás
beige	bege
Beirut	Beirute
Belgian	Belga
Belgium	Bélgica
Belgrade	Belgrado
belief, opinion	opinião
believe, deem	acreditar
believe, deem	crer
bell	campainha
bell	sino
belong to	pertencer
below, beneath, under	sob
below, downstairs, underneath	abaixo
belt	correia
bend, buckle	curvatura
beneath	abaixo de
Benedictine	Beneditino
benefit	benefício
bengal-light	bengal-luz
bengal-lights	bengal-luzes
benign	benigno
bent, curved	curvado
Berlin	Berlim
Bern	Berna
berry	baga
besides	adicionalmente
besides, in addition, moreover	demais
best, better	melhor
bet	aposta
beverage, drink	bebida
beyond	além de
beyond, past, straight past, yonder	além
biased	inclinado
bibliography	bibliografia
bid, offer	oferta
big, great, large, grand	grande
bike, cycle, bicycle	bicicleta
bill, calculation	conta
bill, invoice	factura
bill, ticket, note	bilhete
binary	binário
bind	ligamento
bind, connect, join, tie, tie up, binding	ligar
binoculars	binóculos
biologist	biólogo
birch	vidoeiro
bird	pássaro
birds	pássaros
birth	nascimento
birthday	aniversário
biscuit	biscoito
bison	bisonte
bit	bocado
bit-player	bocado-jogador
bitch	bruaca
bitch	cadela
bitch	puta
bite	mordida
bitter	amargo
black	negro
black	preto
blackberry	amora
blackbird	melro
blackbird	toutinegra
blackness	obscuridade
bladder, bubble	bexiga
blade	lâmina
blame, guilt	culpa
blameworthy	censurável
blank	espaço em branco
blank, white	branco
blanket	cobertor
bleak, chilly, cold	frio
bleed, bleeding	sangramento
blend, mix, mixture	mistura
blind	cego
blink	piscamento
blister, bubble	bolha
block, pack	bloco
blood	sangue
blood-letting	sangue-blood-letting
blood-red	sangue-vermelho
bloody	sangrento
bloom, flower, blossom	flor
blot, blur	borrão
blouse	blusa
blow	soprar
blow, puff	sopro
blue	azul
blunt	sem corte
board, pane, plate	placa
boarding house, boarding school, pension	pensão
boardroom	sala de reuniões
boat	barco
bobbin, coil	bobina
body, corps	corpo
Bohemia	Boémia
boil	fervura
boiler, steam-boiler	caldeira
bold	bold(realce)
bold, corpulent, fat, thick	gordo
Bolivia	Bolívia
bombard	bombardeie
Bombay	Bombaim
bon-bon, bonbon	bombom
bone	osso
bonus	bônus
book	livro
book	livro
booking-office	booking-escritório
booklet	livreto
bookseller	livreiro
bookshop	livraria
boot	bota
booze	bebidas
borax	bórax
Bordeaux	Bordéus
border	beira
bore	verruma
bore, hole	furo
boring	furar
Borneo	Bornéu
Bosnia	Bósnia
Bosnian	Bosniano
bosom	seio
bosom, breast, chest	peito
boss	saliência
boss, master	amo
both	ambos
bother, troublesome	incômodo
bottle	frasco
bottle	garrafa
bottom, foundation, ground, background, fund	fundo
bough, branch	ramo
bouillon	caldo de carne
boulder	pedregulho
boulevard	bulevar
boutique, shop, store	loja
bovine	Bovídeos
bow, curve	curva
bow, prow	proa
box, cashier, chest	caixa
boy	rapaz
boyfriend	namorado
Brabant	Rendas do Brabante
brace, strap	cinta
braces	cintas
braces, suspenders	suspensórios
bracket, holder, pedestal, prop	suporte
brackets	suportes
braid	trança
brain	cérebro
brain	cérebro
brake	freio
brake	travão
brake	travão
braked	travado
brakes	travões
brandy, cognac	aguardente
brandy, cognac	conhaque
brass	bronze
brass	latão
Braunschweig	Bransvique
brave	bravo
Brazil	Brasil
Brazilian	brasileiro
breach, break	ruptura
bread, loaf	pão
break	partir-se
break	romper
breakfast	café-da-manhã
breakfast	pequeno almoço
bream	brema
breath, respiration	respiração
breathe	respire
breather	respiradouro
breed, race	raça
breeze	brisa
Bretagne, Brittany	Bretanha
Breton	Bretão
brick	tijolo
bridge	ponte
bridle	breio
briefcase, paste	pasta
bright, brilliant	brilhante
bring	traga
bristle	cerda
Britain	Grâ Bretanha
Britain, Great Britain	Grã-Bretanha
British, Briton	Britânico
brittle, fragile	frágil
broad	largo
broad, ample	amplo
broadcast	transmissão
broccoli	bróculos
broken	quebrado
broker	corretor
brokerage	agência corretora
broom	vassoura
brother	irmão
brow, eyebrow	sobrancelha
brown	marrom
Brunswick	Brunsvique
brush	escova
Brussels	Bruxelas
Brussels-sprouts	Bruxelas-brussels-sprouts
brute	bruto
Bucharest	Bucareste
bucket	cubeta
bucket, pail	balde
buddy, comrade	camarada
budget	orçamento
buffalo	búfalo
buffer, bumper	amortecedor
buffet	bufete
buffoon	palhaço
bug, insect	inseto
bug, insect, flier	insecto
build, lay	configuração
builder	construtor
builder	lavrador
building	edifício
bulb	bulbo
bulb, lamp	lâmpada
Bulgaria	Bulgária
bulk	volume
bulky	volumoso
bull	touro
bulldozer	escavadora
bullet	bala
bulletin	boletim
bumblebee	zangão
bump, collision	colisão
bunch, crew, gang, group	grupo
bungle	estrague
burden, charge, load, cargo	carga
burdensome, heavy, onerous	pesado
bureau, department	departamento
Burgundy	Borgonha
burn	queimadura
burnt	queimado
burst	estouro
bury	enterro
bus	barra-ônibus
bush	arbusto
Bushman	Bosquímano
business, commerce, trade	comércio
business, trade	transacção
businessman	homem de negócios
busy	ocupado
but	mas
but, however, nevertheless, yet	contudo
but, however, nevertheless, yet, although, though	embora
butcher	açougueiro
butcher	carniceiro
butter	manteiga
butterfly	borboleta
button	tecla
buy, purchase	comprar
buyer	comprador
buzz	zumbido
buzzer	cigarra
bye	assunto secundário
c	terceira letra do alfabeto ingle
c	terceira letra do alfabeto inglês
cab	taxi
cab	viajar em carro
cab-stand	táxi-esteja
cabal	cabala
cabalistic	cabalistico
cabaret	cabaret
cabaret	cabaré
cabbage	couve
cabbage	couve
cabbage	cábula
cabbage	repolho
cabbage	repolho
cabbages	couves
cabby	cocheiro
cabdriver	taxista
cabin	cabana
cabin	cabine
cabin	cabine
cabin	camarote
cabin, hut, shack	cabana
cabinet	armario
cabinet	gabinete
cabinet, closet, cupboard, sideboard	armário
cabinets	armarios
cabins	cabines
cable	cabo
cable, cord, corporal	cabo
cablegram	cabograma
cablegram	cabograma
cables	cabos
cabman	cocheiro
caboose	cozinha de bordo
cabotage	cabotagem
cabriolet	cabriolé
cabs	taxis
cacao	cacau
caches	esconde
cackle	cacarejar
cacophony	cacofonia
cactus	cacto
cadastral	cadastral
cadastre	cadastro
cadaver	cadaver
cadaveric	cadavérico
cadmium	cádmio
cafe	café
cafeteria	cafetaria
caffeine	cafeina
caffeinic	cafeinico
cage	jaula
cage, coop	gaiola
Cairo	O Cairo
cake	bolo
cake	bolo
cakes	bolos
calabash, gourd, pumpkin	abóbora
calamite	Calamidade
calamities	Calamidades
calamitous	calamitoso
calamity	calamidade
calcification	calcificação
calcium	cálcio
calculable	calculavel
calculableness	incalculavel
calculably	calculável
calculate	calcular
calculate	calcule
calculated	calculado
calculating	calculando
calculation	cálculo
calculation, compute	cálculo
calculator	calculador
calculator	calculadora
calculators	calculadora
calendar	calendário
calendar	calendário
calendars	calendários
calender	calandra
calf	vitela
calf	vitelo
calf, belly	barriga
calf, veal	vitela
calfskin	pele de vitela
caliber	pano
calibrate	calibrar
calibrated	calibrado
calibrating	calibrando
calibration	calibramento
calibre	calibre
calico	pano de algodao
California	Califórnia
call	chamada
call	ligar
call	nomear
call, summon	chamar
called	chamado
caller	chamador
calligraph	caligrafia
calligrapher	calígrafo
calling	ligando
callosity	calosidade
callous	calos
calm	calma
cambial	cambial
camel	camelo
camel	camelo
camera	câmera
camera	câmera
camera	maquina fotografica
Cameroun	República dos Camarões
camp	acampamento
camp	acampar
campaign	campanha
camphor	cânfora
can, tin	lata
Canada	Canadá
Canadian	Canadense
Canary	Canário
cancel	cancelamento
candidate	candidato
candidate	candidato
candidates	candidatos
candies	doces
candle	vela
candy	doce
candy, sweet	doce
cannon	canhão
canoe	canoa
cans	latas
canteen	cantina
cap	barrete
cap	bone
cap	tampão
capability	potencialidade
capable	capaz
capacity	capacidade
caper	alcaparra
capital	capital
capital, important	importante
capitalism	capitalismo
capitalist	capitalista
capitalist	capitalista
capitalists	capitalistas
capitulate	capitular
capivara	capibara
capsule	cápsula
captain	capitão
capture	captação
car	auto
car	carro
car, automobile	automóvel
car, cart	carro
carabineer	carabineiro
caramel	caramelo
caravan	caravana
carbon	carbon
carbon-paper	carbono-papel
carburettor	carburador
card, cardboard	cartão
care, caution	cuidado
career	carreira
career	carreira
careful	cuidadoso
careful	cuidadoso
carefully	com cuidado
careless	descuidado
carioca	carioca
carousel, carrousel	carrossel
carp	carpa
carpenter	carpinteiro
carpet	tapete
carriage, coach, railway carriage	carruagem
carriage, coach, railway carriage, waggon	vagão
carrot	cenoura
carry	carregue
carrying	carregar
cartel	cartel
cartographer	cartógrafo
cartographers	cartógrafos
cartography	cartógrafia
cartoon	desenho animado
cartoons	desenhos animados
cartridge	cartucho
cashew-nut	castanha de caju
cassava	mandioca
casserole, saucepan	caçarola
cast, mold, mould, template	molde
cast-off	molde-fora
castle	castelo
castle, tower	torre
Castor	Rodízio
cat	gato
catalog, catalogue	catálogo
catastrophic	catastrófico
catch	prendedor
catching	travar
category	categoria
caterpillar	lagarta
cathedral	catedral
Caucasus	Cáucaso
cauliflower	couve-flor
caulk	calafete
cause, give rise to	causar
cause, reason, sake	causa
cautious	cauteloso
cavalier	mais cavalier
cavalry	cavalaria
cave, cavern	caverna
cavity, hollow	cavidade
cease	cesse
cedar	cedro
ceiling	tecto
ceiling	teto
celebrate	comemore
celebrate	festejar
celebrity	celebridade
celery	aipo
cell, pile, stack	pilha
cellar	adega
Celsius	Célsio
cement	cimento
cemetery, graveyard	cemitério
centavo, cent	centavo
centennial, century	século
center, centre	centro
certain, sure	certo
certainly, indeed, surely	certamente
certificate, script	certificado
certify	certifique
Ceylon	Ceilão
Chad	República do Tchad
chair	cadeira
chair	cadeira
chairman, president	presidente
chalk	giz
chalk	greda
chalk	griz
challenge, dare	desafio
chamber	câmara
chamber, room, fourth, quarter	quarto
chamber-pot	câmara-potenciômetro
chamois	camurça
champagne	champanhe
champion	campeão
chance, possibility	possibilidade
chandelier	mais chandelier
change	mudança
change	troco
channel	canaleta
chaos	caos
chap, crack	rachadura
chaplain	capelão
chapter	capítulo
character	caráter
character, nature, personality	carácter
characteristic	característico
characterization	caracterização
characterize	caracterize
charcoal	carvão de lenha
charm	encanto
charter	carta patente
chase, pursuit	perseguição
chat	bate-papo
chatter, flutter, vibration	vibração
cheap, inexpensive	barato
cheat	fraude
check	verificação
checked	verificado
checker	verificador
checker, controller	revisor
checkers	verificadores
checksum	soma de controle
cheek	face
cheek	mordente
cheese	queijo
chef, chief, chief-	chefe
chemist	farmacêutico
chemist	químico
chemistry	química
cheque-book	cheque-livro
cherry	cereja
cherry-tree	cereja-árvore
cherry-tree	cerejeira
chestnut	castanha
chestnut-tree	castanha-árvore
chestnut-tree	castanheiro
chew	mastigação
chewing-gum	pastilha elástica
chick	pintainho
chicken, fowl, hen	galinha
chicken, hen	frango
chicory	chicória
child, infant	criança
child, infant, boy	menino
child, infant, girl	menina
Chile	O Chile
chilli	pimentões
chimney, smokestack	chaminé
chimpanzee	chimpanzé
chin	queixo
China	China
chip	microplaqueta
chirp	chilro
chisel	cinzel
chisel	formão
chive	cebolinho
choice, choose	escolha
choke	bloqueador
choose, elect, pick out	escolher
Christian	Cristão
Christmas-tree	Christmas-árvore
chunk	pedaço
church, kirk	igreja
church-father	igreja-pai
cider	cidra
cigar	charuto
cigar-end	charuto-extremidade
cigar-stub	charuto-topo
cigarette	cigarro
cinema, Chinese	Chinês
cipher	cifra
circle	círculo
circuit	circuito
circulate	circule
circulation	circulação
circumstance, condition	circunstância
circumstances	circunstâncias
citizen	cidadão
city, town	cidade
city, town, village	vila
civilian	civil
civilization	civilização
claim	reivindicação
clamp	braçadeira
clarify	esclareça
class, grade	classe
classic	clássico
classify	classifique
clatter, tinkle	tinido
clause	cláusula
claw, grab	garra
clay	argila
clean	limpo
clean, cleanse, make clean, purge	limpar
clear	cancele
clear, distinct, plain	claro
clearly	claramente
clergyman	clérigo
clerk	caixeiro
clever, intelligent	inteligente
click	clique
client, customer	freguês
cliff	penhasco
climate	clima
climatic	climático
climb	escalada
clinic	clínica
clip, staple	grampo
cloak	casaco
cloakroom	guarda-roupa
clock	pulso de disparo
clockwise	no sentido horário
clog	obstrução
close, shut	fechar
cloth, rag	pano
clothes, clothing	roupa
clothes, clothing	roupas
clothes-press	roupa-pressione
cloud	nuvem
clove-cheese	cravo-da-índia-queijo
clover	trevo
club	clube
clubs	clubes
clutch	embreagem
co-operate, cooperate	coopere
co-ordinate	coordene
coach	ônibus
coach-work	ônibus-trabalhe
coal	carvão
coarse	grosseiro
coast, seaside, shore, strand	costa
coat, finish, jacket	revestimento
cocaine	cocaína
cock, rooster	galo
cock, tap	torneira
cockroach	barata
coco-nut, coconut	coco
cocoa	cacau
cocoa-nut	cacau-porca
coconut-palm	coco-palma
cocoon	casulo
cod, codfish	bacalhau
code	código
codfish	bacalhaus
codfish-oil	bacalhau-óleo
coffee	café
coffee-pot	cafeteira
coffee-pot	café-potenciômetro
coffin	caixão
coin	moeda
coincide	coincida
cold	constipação
cold	resfriado
collapse	colapso
collar	colar
collar	colarinho
colleague	colega
collect, gather, pick up, spoon	colher
collection	coleção
collective	coletivo
college, faculty	faculdade
collide	colida
Cologne	Colónia
Colombia	Colômbia
colonel	coronel
colony	colônia
colour, dye, color	cor
colour-blind	cor-cego
Columbus	Columbo
column, pillar	coluna
comb	pente
combination	combinação
combine	combinar
combustion	combustão
come	vindo
comedy	comédia
comfort	conforto
comfortable	confortável
comfortable	cómodo
comfortable	cômodo
comfortably	confortavelmente
coming	vinda
comma	vírgula
command	comando
command	mando
command, order, dictate	ordem
commander	comandante
commend	elogíe
comment	comentário
commissioner	comissário
committee	comitê
commodity	producto
common	comum
communicate	comunique-se
communication	uma comunicação
communication-cord	comunicação-cabo
communist	comunista
community	comunidade
commute	comute
compact	estojo compacto
companion, fellow	companheiro
company	companhia
comparatively	comparativamente
comparison	comparação
compartment, coupé, magazine	compartimento
compass	bússola
compass	compasso
compatible	compatível
compel	compila
compensate	compense
compensation	compensação
compensation, reward	recompensa
compete	compita
competent	competente
competition	competição
compilation	compilação
compiler	compilador
complain	queixe-se
complaint	queixa
complementary	complementar
complete	completo
complete, full	cheio
completed, finished	terminado
completely, entirely, altogether, full, precious	completamente
complex	complexo
complexion	tez
complicate	complique
complicated	complicado
compliment, praise	elogio
compose	componha
composer	compositor
composing	compôr
composition, make-up	composição
comprehensive, detailed	detalhado
comprehensively	detalhada
compress	compressa
comprise, contain, include	conter
comprise, understand	compreenda
compulsory	compulsório
computer	computador
concave	côncavo
conceal	esconda
concentrated	concentrado
concept	conceito
concern, interest	interesse
concerned, interested	interessado
concerning	concernir
concert-room	concert-quarto
concise	conciso
conclude	concla
conclusion	conclusão
concrete	concreto
concrete	formigão
conference	conferência
confide	confíe
confidence, trust	confiança
confident	confiável
confined	confinado
confirm	confirme
confirmation	confirmação
conflict	conflito
conform	conforme-se
conforming	conformar-se
confront	confronte
confusing	confundir
confusion	confusão
congratulate	felicite
conjunction, joint, junction	junção
connect	conecte
connection	conexão
connection, bond, lead, link	ligação
conquer	conquiste
conscientious	consciencioso
consecutively	consecutivamente
consent	consentimento
consequence	conseqüência
consequently, therefore	conseqüentemente
conservative	conservador
consider	considere
considerable, handsome	considerável
considerably, pretty	consideravelmente
consignee	consignatário
consignee, recipient, addressee	destinatário
consist	consista
consistency	consistência
consistent	consistente
consonant	consoante
constant	constante
constantly	constantemente
constitute	constitua
construct	construção
consul	cônsul
consulate	consulado
continually, continuously	continuamente
continuation, follow-up	continuação
continuous, solid	contínuo
contour	contorno
contract	contrato
contractor	contratante
contrary	contrário
contrast	contraste
contribute	contribua
contribution	contribuição
control, govern, restrain, rule	reger
control, manage	controle
controller	controlador
controversy	controvérsia
convenient	conveniente
convention	convenção
converge	convirja
conversation	conversação
converse	inverso
convert	converso
convey	faça saber
conviction	convicção
convince	convença
cook	cozinheiro
cook, female cook	cozinheira
cooked	cozinhado
cool, fresh	fresco
coordinate	coordenada
Copenhagen	Copenhaga
coping	lidar
copper	cobre
copy, print	cópia
copyright	direitos reservados
cord, rope, string, chord	corda
core, nucleus	núcleo
cork	cortiça
corkscrew, cork-screw	saca-rolhas
corn, Indian corn, maize, mealies	milho
corner	canto
correct	correto
correspond	corresponda
corridor, runner	corredor
corridor-train	corredor-treine
corrode	corroa
corrugate	corrugue
Corsica	Córsega
cost	custar
cost	custo
costume	traje
cottage	casa de campo
cotton	algodão
couch, divan	divã
couch-grass	couch-grama
counsel	conselhos
counsellor	conselheiro
count	conde
count, score	contagem
countability	contabilidade
counterespionage	contraespionagem
counterfeit	moeda falsa
counterintelligence	contrainteligência
countermand	contra-ordem
countless	incontável
country, countryside, field	campo
country, land	país
countryman	compatriota
county	condado
couple	pares
courage	coragem
course, dish, platter	prato
course, stroke, travel	curso
court, cut, hack	corte
court, yard, courtyard	pátio
cousin	prima
cousin	primo
cover, lid	tampa
cow	vaca
cowardice	cobardia
cowboy	vaqueiro
cowl	capuz
coyote	chacal
cracked	rachado
cradle	berço
cramp-iron	grampe-ferro
crane	guindaste
crawl, creep	rastejamento
crayfish	lagostas
crayfish, crab	caranguejo
craze	mania
crazy, mad	louco
cream	creme
cream	nata
crease	vinco
create	críe
creature	criatura
credential	credencial
credit	crédito
cremation	cremação
crevice	fenda
crew	equipagem
crew	tripulação
cricket	grilo
Crimea	Crimeia
crippled	aleijado
crisis	crise
critical	crítico
criticize	critique
crocodile	crocodilo
crocus	açafrão
crook	trafulha
cross	cruz
crosswise	transversalmente
crow-bar, crowbar, lever	alavanca
crowd	multidão
crown	coroa
crucifix	crucifixo
crude, raw, rough	cru
crumb	migalha
crush	esmagamento
cruzeiro, cruise	cruzeiro
cry, scream, yell	grito
cry, weep	chorar
crystal	cristal
Cuba	Cuba
Cuban	Cubano
cube, hub	cubo
cuckoo	cuco
cucumber	pepino
cul-de-sac	beco sem saída
culprit, guilty	culpado
cultivate	cultive
culture	cultura
cultured	cultivado
cup	chávena
cup	taça
cup	xícara
cupidity	cupidez
cupola	cúpula
cupric	cúprico
curator	curador
curatorship	curadoria
curiosity	curiosidade
curious	curioso
currant	passa de Corinto
currant-bush	passa de Corinto-arbusto
currant-jam	passa de Corinto-atole
currant-leaf	passa de Corinto-folha
currency	moeda corrente
current	atual
current, flow, stream, chain	corrente
currently	atualmente
curry	caril
curtain, blind	cortina
cushion	coxim
custom	costume
custom-house	alfândega
customary	habitual
customs	costumes
cutlet	costeleta
cutlet	costoleta
cybernetics	cibernética
cycle	ciclo
cycle-bag	ciclo-saco
cylinder, drum	cilindro
cynical	cínico
cypres	cipreste
Cyprus	Chipre
Czechoslovakia	Checoslovaquia
Czechoslovakia	Checoslováquia
d	quarta letra do alfabeto
D-chord	D-corda
dab	pequena quantidade
dab	toque
dad	PAPAI
daddies	papais
daddy	papai
dads	pais
daemon	demônio
daemons	demônios
dagger	adaga
dagger	punhal
daggers	punhais
daguerreotypes	daguerreótipo
dahlia	dáhlia
daily	DIARIAMENTE
daily	diáriamente
daily	diário
daily, diary, everyday	diário
daintily	saborosamente
daintiness	delicadeza
dainty	guloseima
dainty	saboroso
daiquiri	daiquiri
daiquiris	daiquiris
dairy	leitaria
dairy	leiteria
dairy	LÁCTEO
dairy	queijaria
dairyman	leiteiro
dais	plataforma
daisies	margaridas
daisy	bem-me-quer
daisy	MARGARIDA
Dakar	Dacar
dale	pequeno vale
dalmatian	DÁLMATA
dalmatians	DÁLMATAS
dam	represa
damage	dano
damage	os danos
damaged	danificado
damaged	danificado
damager	danificador
damagers	danificadores
damages	danos
damaging	danoso
damask	damasco
dame	dama
damp, moisture	umidade
dampen	umedeça
dance	dança
dancer	dançarino
Dane, Danish	Dinamarquês
danger, peril, hazard	perigo
dangerous, hazardous	perigoso
Danube	Danúbio
daring	audaz
dark	escuro
darken	escureça
darkness	escuridão
darling	querido
data, dice	dados
date	data
date	tâmara
date-palm	data-palma
daughter	filha
dawn	alvorecer
day	dia
day-dreamer	dia-day-dreamer
day-ticket	dia-bilhete
daybreak	aurora
daylight	luz do dia
deacon	diácono
dead	inoperante
deadly	mortal
deaf	surdo
dean	decano
dear, expensive, lovely, valuable, costly	caro
death	morte
debatable	discutível
debit, debt	débito
debris	restos
decade	década
decay	deterioração
decayed	deteriorado
deceive	iluda
December	Dezembro
decide	decida
decipher	decifração
decision	decisão
deck	coberta
declaration	declaração
decline	declínio
decoction	decocção
decode	descodifique
decorate	decore
decoration	decoração
decrease	diminuição
dedicate	dedique
deduce, deduct	deduza
deem	julgue
deep	profundamente
deer	cervos
defeat	derrota
defence, defense	defesa
defend	defenda
defendant	réu
define	defina
definite	definitivo
definitely	definitivamente
definition, resolution	definição
deformed	deformado
defraud	defraude
degree	grau
delay, retardation	atraso
delegate	delegado
delete	supressão
Delhi	Deli
deliberately	deliberadamente
delicate, gentle	delicado
delicious, delightful	delicioso
delight, pleasure	prazer
delighted	deleitado
deliver	entregue
delivery	entrega
demand	demanda
democracy	democracia
democrat	democrata
democratic	democrático
demonstrate	demonstre
demonstration	demonstração
demonstrative	demonstrativo
den, nest	ninho
Denmark	Dinamarca
dense	denso
dentist	dentista
deny	negue
depart	parta
departure	partida
depend	dependa
dependence	dependência
dependent	dependente
depict, describe	descreva
deposit	depósito
depress	comprima
depth	profundidade
depute	delegue
deputy	deputado
derivation	derivação
descend	desça
descend, go down	descer
descent	descida
description	descrição
desert	deserto
deserve	mereça
deserving	merecer
deserving, worthy	digno
design, project	projeto
desire, want, wish	anseio
desire, wish	desejar
desire, wish	desejo
desire, wish, willing	querer
desk, writing desk, writing-desk, office	escritório
desolate	desolado
despair	desespero
desperate	desesperado
despite	despeito
destroy	destrua
destruction	destruição
detachable	destacável
detached	destacado
detachment	destacamento
detail	detalhe
detain	detenha
detective	detetive
detergent	detergente
deterrent	impedimento
detrimentally, harmful	prejudicial
develop	torne
development	desenvolvimento
device	dispositivo
devil	diabo
devoted	devotado
dew	orvalho
diagram	diagrama
dial	seletor
dialog, dialogue	diálogo
diameter	diâmetro
diamond	diamante
dictator	ditador
dictionary, vocabulary	dicionário
die	dado
die, expire, pass away	morrer
diet	dieta
dietary	dietético
differ	difira
difference	diferença
different	diferente
differentiate	diferencie
differently	diferentemente
difficult, hard, inconvenient	difícil
difficulty	dificuldade
dig	escavação
digestion	digestão
digit	dígito
dignity	dignidade
dilapidated	dilapidado
diligent, hardworking, industrious	aplicado
dilute	diluído
dim	não ofuscante
dimension	dimensão
diminutive, little, small	pequeno
dinner	jantar
dinner, midday meal	almoço
dip, dive, plunge	mergulho
diplomat	diplomata
direct, straightforward	direto
direction	direcção
direction	direção
direction, sense	sentido
directions	sentidos
directly	diretamente
director	diretor
director, manager	director
directory	diretório
dirty, filthy, nasty, soiled, unclean, foul	sujo
disadvantage	desvantagem
disadvantageous	desvantajoso
disappear	desapareça
disappoint	decepcione
disappointment	desapontamento
disapproval	desaprovação
disarm	desarme
discard	descarte
discharge	descarga
discipline	disciplina
discount	disconto
discourage	desanime
discover, uncover	descubra
discovery	descoberta
discovery	descobrimento
discrete	discreto
discrimination	discriminação
discussion, quarrel	discussão
disease, illness	doença
disgust	aversão
disgusting	repugnar
dislike	desagrado
dislocate	desloque
dismay	desânimo
dismiss	demita
dismount	desmonte
dispatch, expedition	expedição
disperse	dispersão
display, expose, exposition	exposição
disposal	eliminação
disposition	disposição
dispute	disputa
dissipation	dissipação
dissolve	dissolva
distance, offset	distância
distinct	distinto
distinction	distinção
distinctive	distintivo
distinguish	distinga
distribute	distribua
distribution	distribuição
distributor	distribuidor
district	distrito
disturb	perturbe
disturbance	distúrbio
ditch	vala
diver	mergulhador
diverse	diverso
diversion	diversão
divert	desvíe
divide	divida
divide, separate, share	dividir
diving-bell	diving-sino
division	divisão
divorce	divórcio
divorced	divorciado
dock	doca
doctor	doutor
doctor, physician, medical	médico
document, unique	original
dog	cachorro
dog	cão
dogged	persistente
dogma	dogma
doll	boneca
dollar	dólar
dome	abóbada
domestic, tame	doméstico
dominate	domine
donate	doe
done	feito
donkey	asno
door, gate	porta
dot, point, spot, stitch	ponto
double	dobro
doubt	duvidar
doubt	dúvida
doubtful	duvidoso
dough	massa de pão
dove	pomba
dove	pomba
dove, pigeon	pombo
down	debaixo
down	para baixo
dozen	dúzia
draft, outline, sketch	esboço
drag	arrasto
drag, draw, haul, pull, tug	puxar
dragonfly	libélula
drain	dreno
drama	drama
drape	drapeje
drastic	drástico
draw	empate
draw, drift, pull	tração
drawer, cassette	gaveta
drawers	gavetas
drawers, panties, underpants	ceroulas
drawing	desenho
drawing-paper	extra-papel
dream	sonho
dress, gown	vestido
dress-coat	vist-revestimento
dresser	aparelhador
drill	brocas
drink	beber
drip	gotejamento
drive	movimentação
driver	excitador
driving-licence	driving-licencíe
droop, inclination, slope, tilt	inclinação
drop, droplet	gota
drop, fall, hang	cair
drown	afogue-se
drug	droga
drugstore	drograria
drunk	bêbedo
dry	seco
dual	duplo
duck	pato
dude	gajo
dues	dívidas
duke	duque
dull	maçante
dunning-letter	dunning-letra
duplicate	duplicata
dust	poeira
dust, powder	pó
dusty	empoeirado
Dutchman, Hollander, Dutch	Holandês
duty	dever
dwarf, midget	anão
dwell, interrupt	interrupção
dwell, live	morar
dwelling	moradia
dwelling-place	moradia-lugar
dye	tintura
dynamite	dinamite
E-chord	E-corda
each	cada
each	cada um
eager	ávido
eagerly	avidamente
eagerness	avidez
eagle	águia
eagle	águia
eagles	águias
ear	orelha
ear	orelha
ear	ouvido
earache	dor
early	cedo
earn	ganhe
earn	merecer
earn, gain, win	ganhar
earned	merecido
earnest, serious	sério
earphone	auscultador
earphones	auscultadores
earring	brinco
earrings	brincos
ears	orelhas
earth	terra
earth, land, soil, farmland, ground	terra
earthling	extraterrestre
earthquake	terremoto
earthquake	terremoto
earthquakes	terremotos
earths	terras
earthworm	minhoca
earthworm	minhoca
earthworms	minhocas
ease	facilidade
easel	armação
easily	facilmente
easily	fàcilmente
East	Do leste
east	este
east, East	leste
eastern	oriental
easy, facile	fácil
eat	coma
eat	comer
ecclesiastic	eclesiástico
echo	eco
economical	econômico
economics, economy	economia
Ecuador, equator	Equador
edge, rim	borda
Edinburgh	Edimburgo
edit	edite
edition, issue	edição
educate	eduque
educated	educado
education, instruction	instrução
eel	enguia
eel-skin	enguia-pele
eel-trap	enguia-prenda
effect	efeito
effective	eficaz
egg	ovo
Egypt	Egipto
eight	oito
eighteen	dezoito
eighteen	dezóito
eighteenth	décimo oitavo
eighth	oitavo
elastic	elástico
elbow	cotovelo
elder	pessoa idosa
elderly	idoso
elect	eleja
elected	eleito
election	eleição
electric	eléctrico
electric	elétrico
electricity	electricidade
electricity	eletricidade
electron	elétron
electronic	eletrônico
electronics	eletrônica
elegant	elegante
elegant	esbelto
element	elemento
elementary	elementar
elephant	elefante
elevator, lift	ascensor
elevator, lift	elevador
eleven	onze
eliminate, exterminate	elimine
elk, moose	alces
elm	olmo
elsewhere	em outra parte
elver	enguia jovem
embassy	embaixada
embrace, hug	abranger
embroider	borde
emerge	emerja
emergency	emergência
eminent	eminente
emit	emita-se
emotion	emoção
emphasize	emfatize
emphasize, underline	sublinhar
empire	império
employ	empregue
employ, use, make use of	empregar
employ, use, make use of	usar
employee, servant	empregado
employer	empregador
employment	emprego
empty	vazio
empty, void, vacuum	vácuo
enamel, glaze	esmalte
enclose, include	inclua
enclosure	cerco
encode	codifique
encounter	encontro
encourage	incentive
encouragement	incentivo
encyclopedia	enciclopédia
end	extremidade
end, ending, close	fim
end-of-the-line	extremidade-$$$-$$$-linha
endanger	ponha em perigo
endlessly	infinita
endorse	endosse
endorsee	endossado
endorsement	endosso
endorser	endossante
endow	dote
endure, resist	resista
enemy	inimigo
energetic	energético
energy	energia
engaged	acoplado
engine, locomotive	locomotiva
engine, motor	motor
engineer	coordenador
engineer	engenheiro
England	Inglaterra
Englishman, Sassenach, English	Inglês
engrave	grave
enhance	realce
enjoy	aprecíe
enjoyable, nice, pleasant	agradável
enlarge	amplíe
enlargement	ampliação
enlist	aliste
enormous, huge	enorme
enormously	enormemente
enough	bastantes
enough, rather, sufficiently	bastante
enterprise	empresa
enterprising	empreendedor
enthusiasm	entusiasmo
enthusiastic	entusiástico
entice, seduce	seduza
enticing	seduzir
entire, integer, whole	inteiro
entirely, fully	inteiramente
entirety	totalidade
entrance, portal, doorway, entry, inlet, input	entrada
envelope	envelope
environment	ambiente
equal	igual
equality	igualdade
equally	ingualmente
equilibrium	equilíbrio
equinox	equinócio
equip, team	equipe
equipment, outfit, rig	equipamento
equivalent	equivalente
erase	apague
eraser	eliminador
erect	ereto
erecting	erigir
erroneous	errôneo
escort	escolta
escudo, shell	escudo
Eskimo	Esquimó
especially, special	especial
essence	essência
essential	essencial
establish	estabeleça
establishment, settlement	estabelecimento
estate, farm, property, ranch	fazenda
estate, farm, property, ranch	granja
estate, property	propriedade
esteem, regard, respect	respeito
estimate	estimativa
Estonia	Estónia
etc.	etc..
etching	gravura a água-forte
ethic	éticas
ethical	ético
Ethiopia	Etiopia
Ethiopia	Etiópia
Europe	Europa
European	Europeu
evacuate	evacue
evaporate	evapore
even	mesmo
even	nivele
even, till, until	até
evening meal, supper	ceia
evening, night	noite
event	evento
every	cada
everyone, everyone's	todos
everywhere	em toda parte
evident	evidente
evolution	evolução
evolve	evolua
exact	exacto
exactly	exatamente
exactly	justamente
examination	examinação
example	exemplo
exceed	exceda
excellency	excelência
except	exceto
exception	exceção
exceptional	excepcional
excessive	excessivo
excessively	excessivamente
exchange, swap	troca
excise-duty	excise-dever
excitation	excitação
excitement	excitamento
exciting	excitar
exclude	exclua
exclude	excluir
exclusive	exclusivo
exclusively	exclusivamente
exclusively, just, only	somente
exclusively, just, only, lonely	só
excursion, outing, sightseeing trip, tour	excursão
excuse	desculpa
excuse me	desculpe
excuse me	perdoe-me
execute	executar
exercise, practice	exercício
exert	exerça
exhausted	esgotado
exhibit	exibição
exist	exista
exist	existir
existence	existência
exit, way out, output	saída
expansion	expansão
expedite	expida
expel	expila
expense	despesa
expenses	despesas
experience, experiment	experiência
experienced	experiente
explain	explicar
explain	explique
explanation	explanação
explanation	explicação
explode	expluda
exploration	exploração
explosion	explosão
export	exportação
express	expressar
expression	expressão
extend	estenda
extension	extensão
extensive	extensivo
external	externo
extinguish	extinga
extract	extrato
extraordinarily	extraordinària
extraordinary	extraordinário
extreme	extremo
extremely	extremamente
eye	olho
eyelid	pálpebra
fabric	fábrica
fabric, screen	tela
fabricant	fabricante
fabricate	fabrique
fabricated	fabricado
fabrication	fabricação
fabulous	fabuloso
fabulously	fabulosamente
fabulousness	fabulosidade
face	cara
face	cara
face-ache	cara-face-ache
facilitate	facilite
factory	fábrica
fade	desvaneça-se
fail, failure, fault	falha
faint, light, weak	débil
faint, light, weak, infirm	fraco
fair	justo
fairly	razoavelmente
faith	fé
faithful	fiel
fall	queda
false	falso
fame	fama
fame, glory, renown	glória
family	família
famous	famoso
fan, ventilator	ventilador
fancier	mais extravagante
fancy	fantasia
fantastic	fantástico
Far East, the Far East	Extremo-Oriente
farmer	fazendeiro
fascinate	fascine
fascinated	fascinado
fashion, mode	moda
fashion, shape	forma
fast train, express	expresso
fast, quick, rapid, speedy, swift	rápido
fast, quickly, swiftly	depressa
fasten	prenda
fat, grease	gordura
father, parent	pai
fatigue	fatiga
favorite, favourite	favorito
favour	favor
favourable	favorável
fear	medo
fear	receio
feast	festa
feather, pen	pena
feature	característica
February	Fevereiro
feed	alimentação
feel	sensação
feeling	sentimento
feign, pretend	finja
fellow, man	homem
fellow-creature	companheiro-criatura
fellow-thinker	companheiro-fellow-thinker
felt	feltro
female	fêmea
ferry	balsa
fertile	fértil
fertilizer	fertilizante
fervor, fervour, zeal	zelo
fetch	busque
fever	febre
few	poucos
fiancé	noivo
fiber, fibre	fibra
field, meadow	prado
fierce	feroz
fifteen	quinze
fifty	cinqüênta
fig	figo
fig-tree	fig-árvore
fig-tree	figueira
fight	luta
fight, struggle	pelejar
figurative	figurativo
figure	figura
file	lima
file, line, rank, row, turn	fila
files	limas
fill	suficiência
fill, fill in, fill up, stuffing	encher
film	película
filter, strainer	filtro
fin	aleta
fin	barbatana
final	final
finance	finanças
financial	financeiro
find	achado
fine	muito bem
fine	multa
fine, great	excelente
finger	dedo
finished, ready, through	pronto
Finland	Finlândia
Finn	finlandês
fir	abeto
fire	fogo
fire-alarm	fogo-alarme
firing-cap	acendimento-tampão
firm	firma
firmly, tight, tightly	firmemente
first	primeiramente
first	primeiro
first name	apelido
first-aid	de primeiros socorros
first-aider	primeiro-ajudante
fish	peixe
fish	peixes
fisherman	pescador
fishing rod	cana
fist, handle	punho
fitting	caber
five	cinco
fix, repair	reparo
fixed	fixo
flame	chama
flame	flama
flammable	inflamável
Flanders	Flandres
flare	alargamento
flat, smooth	liso
flatter	alisador
flavor, flavour	sabor
flea	pulga
flee	fuja
fleet	frota
flesh, beef, meat	carne
flexible	flexível
flicker	cintilação
flight	vôo
fling	arremesse
float	flutuador
float, swim	nadar
flock, herd	rebanho
flood	inundação
floor	assoalho
floor	soalho
floor, storey, story	andar
Florence	Florença
flounder	solha
flour	farinha
flourish	floresça
flow	fluxo
flu, grip, influenza	gripe
fluid, liquid	líquido
Flushing	Nivelar
flute	flauta
fly	voar
fly, housefly	mosca
foam, froth	espuma
focus	foco
fog, mist	neblina
fog, mist	névoa
fold	dobra
folder	dobrador
folk, nation, people	povo
folk, people	povos
follow	sequir
follow	siga
followers	seguidores
following	seguir
food	alimento
food	comida
fool	tolo
foot, paw, leg	pé
footwear	calçados
for	eva
for, during, while, whilst	durante
for, to, in order to, toward, towards	para
forbid	proibido
forbidding	proibir
force, strength	força
forecast	previsão
foreground	primeiro plano
forehead	fronte
forehead, brow	testa
foreign	extrangeiro
foresee	preveja
forest, woods	floresta
forever	para sempre
foreword, preface	prefácio
forfeit, loss	perda
forge	forja
forged	forjado
forget	esquecer-se
forget	esqueça-se
forgive	perdoe
fork	forquilha
fork, yoke	garfo
form	formulário
former	anterior
formerly	anteriormente
formula	fórmula
formulate	formule
fortunate	afortunado
fortunate, happy	feliz
fortunately	felizmente
fortune	fortuna
forty	quarenta
forward	para diante
found	encontrado
foundation	fundação
fountain, source, spring	nascente
fountain, source, supply	fonte
four	quatro
fourteen	catorze
fourteen	quatorze
fourth, fifth	quinto
fox	raposa
fraction	fração
fracture	fratura
fragment, shatter	fragmento
fragrant	perfumado
framework, structure	estrutura
France	França
Frankfurt	Francoforte
free	livre
freedom	liberdade
freezing cold, frost	geada
Frenchman, French	Francês
frequent	freqüente
frequently	freqüentemente
friction	fricção
Friday	Sexta-feira
friend	amiga
friend	amigo
friendly	amigável
friendship	amizade
frog	râ
frog	rã
from	de
front	parte dianteira
frontier	fronteira
frosted	geado
frozen	congelado
fruit	fruta
frustrate	frustre
fry	frite
frying-pan	frigideira
fuck	foda
fuck	foder
fuel	combustível
fume	emanações
function	função
function, operate, run, work	funcionar
fungus	fungo
funnel	funil
funny	engraçado
furnace	fornalha
furnish, provide	forneça
furnished	fornecido
furniture	movéis
further	mais adicional
furthermore, moreover	além disso
fuse	fusível
future	futuro
gad-fly	gad-voe
gag	mordaça
gain	ganha
gain	ganham
gain	ganhamos
gain	ganhar
gain	ganhas
gain	ganho
gain	ganho
gained	ganhamos
gained	ganharam
gained	ganhaste
gained	ganhei
gained	ganhou
gal	moça
Galicia	Galiza
gall	bílis
gallery	galeria
game, play, set	jogo
garage	garagem
garden	jardim
garden	jardim
gardener	jardineiro
gardener	jardineiro
gardening	jardinar
gardens	jardims
garlic	alho
garlic	alho
gas	gás
gasolene, gasoline, petrol	gasolina
gather, gathering	recolhimento
gaunt, lean, slender, thin	delgado
gaze, look	olhar
gazette, magazine, newspaper, journal	jornal
gear	engrenagem
gear-box	caixa de engrenagens
general	geral
generally, usually	geralmente
generate	gere
generation	geração
generous	generoso
Geneva	Genebra
genius	gênio
gentle, mild	suave
gentleman	cavalheiro
gently	delicadamente
genuine	genuíno
genuinely	genuìna
geographic, geographical	geográfico
geography	geografia
geologist	geólogo
geology	geologia
geometry	geometria
Georgia	Geórgia
germ	germe
German	Alemão
Germany	Alemanha
gesture	gesto
get angry	zangar-se
get, have, receive	receber
get-at-able	começ-$$$-capaz
giant	gigante
gift	dádiva
gift, present	presente
gigantic	gigantesco
gill	brânquia
girl, lass	garota
girl, lass	moça
girl, lass	rapariga
girlfriend	namorada
give	elasticidade
glacier	geleira
glad	contente
gladness, joy	alegria
glass	vidro
glass, cup	copo
glasses	vidros
glasses, spectacles	óculos
glide	deslize
glider	planador
globe	globo
globe-trotter	globo-trotador
glorify	glorifice
gloss	lustro
glossary	glossário
glove, mitten, sleeve	luva
glow	fulgor
glue	colagem
glue, stick	solfar
gnat-bite	mosquito-mordida
gnaw	roer
go	ir
go	vá
Go with god	A te dios
goal	objetivo
goat	cabra
god	deus
gold	ouro
gold-coloured	ouro-colorido
golden	dourado
good, nice, okay	bom
good-looking	bem parecido
good-smelling	bom-good-smelling
goods	bens
goose	ganso
gooseberry	groselha
gossip	bisbolhetice
govern	governe
government	governo
graceful	gracioso
gradually	gradualmente
graduate	graduado
grain, grit	grão
gram, gramme, grass	grama
grammar	gramática
grammophone disc, disc, disk	disco
grand-nephew	grande-grand-nephew
grandfather	avô
grandmother	avó
grandson	neto
granite	granito
grape	uva
graphic	gráfico
graphics	gráficos
grasp, grip, squeeze	aperto
grass	erva
grasshopper, locust	gafanhoto
gratis	gratuitamente
gratitude	gratidão
gratitude, thanks	agradecimento
grave	sepultura
gravel	cascalho
gravity	gravidade
gravy, sauce	molho
gray, grey	cinzento
graze	paste
grease	graxa
greasy	gorduroso
great-grandfather	grande-avô
great-grandmother	grande-avó
great-grandparent	grande-grandparent
Greece	Grécia
Greek	Grego
green	verde
Greenland	Gronelândia
greet	cumprimente
greeting	cumprimento
grid, grill	grade
grieve	aflija-se
gripped	prendido
groan	gemido
ground-floor	rés-do-chão
ground-floor	térreo
grounding	aterrar
grounds	terras
grow	crescer
grow	cresça
growl	rosnado
growth	crescimento
guarantee	garantia
guard, conductor	condutor
guard, shield	protetor
guelder-rose	guelder-levantou-se
guest	convidado
guest	hóspede
guide	guia
guinea-pig	cobaia
guitar	guitarra
gulf	golfo
gum	gengiva
gun	injetor
gun, rifle	espingarda
gun-carriage	injetor-carruagem
gurgle	gorgolejo
Gypsy	Cigano
H-bomb	H-bomba
ha	ah!
habit	hábito
habitants	habitantes
hack	cortar
hack	escritor
hack	escritor de meia-tigela
hack	talhar
hack	tosse seca
hack	tossir
hack	tossir secamente
hacked	cortado
hacked	talhado
hacker	mutilador
hackers	mutiladores
hail	granizo
hail	saraiva
hair	cabelo
hair	cabelo
hair	pêlo
hair-do	cabelo-
hair-splitter	cabelo-divisor
hair-splitting	cabelo-hair-splitting
hairbrush	escova de cabelo
haircut	corte de cabelo
haircuts	cortes de cabelo
hairdresser	cabeleireiro
hairdresser, female hairdresser	cabeleireira
hairdressers	cabeleireiros
hairpin	alfinete
hairs	cabelos
half	metade
half, mean	meio
half-tone	reticulação
hall	salão
halt, come to a halt, stop	parar
halt, parade	parada
halyard	adriça
ham	presunto
Hamburg	Hamburg
Hamburg	Hamburgo
hammer	martelo
hammering	martelar
hand	mão
hand, laborer, labourer, operative	obreiro
handbook	manual
handful	punhado
handkerchief	lenço
handlebars, helm, rudder	leme
hang-glider	pendur-planador
happen	aconteça
happiness	felicidade
harbor, harbour, port	porto
hard	duramente
hard-worked	duro-trabalhado
harden	endureça
hardness	dureza
hare	lebre
haricot, bean	feijão
harm	dano
harmonica	harmônica
harmony	harmonia
harness	chicote de fios
harsh, rough	áspero
harvest	colheita
haste, hurry	pressa
hastily, hurriedly, in a hurry	precipitadamente
hat	chapéu
hate	ódio
have	tenha
have, have got	haver
Hawaii	Havaí
Hawaiian	Havaiano
hawk	falcão
hay	feno
hazard, risk, scratch, venture	risco
haze	embaçamento
hazelnut	avelã
he, him, it	ele
head, pate	cabeça
header	encabeçamento
heading, title	título
headquarters	matrizes
health	saúde
healthy	saudável
hear	ouvir
hear	ouça
heart	coração
heat	calor
heater	calefator
heaven, sky	céu
heel	talão
heel, jump	salto
helix, propeller	hélice
hell	inferno
helmet	capacete
help	ajuda
help	auxilio
help	auxílio
help	socorro
helper	ajudante
helper	auxiliador
helper	auxiliar
helpful	proveitoso
helpful	útil
helpful	útil
helpfully	de maneira proveitoso
helpfulness	auxilio
helpless	sem recursos
helplessly	irremediavelmente
helplessness	abandono
helplessness	desamparo
helpmate	companeiro
Helsinki	Helsínquia
helve	cabo
hem	bainha
hematite	hematite
hemisphere	hemisfério
hence	daqui
her, she	ela
here	aqui
here	aqui
here, hither	cá
hero	herói
herring	arenque
hers	dela
herself	ela mesma
hesitation	hesitação
hidden	escondido
high tide	preamar
high, lofty	elevado
high, lofty, tall, top	alto
high-handedness	elevado-high-handedness
hill	colina
himself	ele mesmo
hindmost	mais hindmost
hinge	dobradiça
hint, suggestion	sugestão
hip	quadril
hiss	silvo
history	história
hobby	passatempo
hobby	passatempo
hoe	enxada
hold, basement	porão
holiday	feriado
holiday	féria
holiday	sueto
Holland	Holando
honest	honesto
honey	mel
honor, honour	honra
hood	capa
hoof	casco
hook	anzol
hook	gancho
hooter	buzina
hope	esperança
hopefully	esperançosamente
horizon	horizonte
horn	chifre
horse	cavalo
horse-fly	cavalo-voe
horsepower	cavalos-força
horseshoe	ferradura
hospital	hospital
host	anfitrião
hostage	refém
hostile	hostil
hot	cálido
hot	quente
hotel	hotel
hour	hora
house, house-	casa
hover	pairo
how?	como?
however	entretanto
hub-cap	cubo-tampão
hug	abraço
human, humane	humano
humanist	humanista
humid, moist	húmido
hundred	cem
Hungarian	húngaro
Hungary	Hungria
hunger	fome
hungry	com fome
hunt	caça
hunter	caçador
hurricane	furacão
hurried	apressado
husband	marido
husband, spouse	esposo
hygiene	higiene
hygienic	higiênico
hypothesis	hipótese
hypothetical	hipotético
I can't speak portuguese	Eu não sei falar português
I.D.	Identificação.
ice	gelo
Iceland	Islândia
icing	crosta de gelo
icon	ícone
icy	gelado
idea	idéia
identical	idêntico
identify	identifique
identity	identidade
idiotic	idiota
if, provided that	si
if, provided that, should, whether	se
ignition	ignição
ill, sick	doente
illuminate	ilumine
illustrate	ilustre
illustration	ilustração
image	imagem
image, picture, frame	quadro
imagination	imaginação
immaterial	imaterial
immediate, instant	imediato
immediately, instantly	imediatamente
immune	imune
impartial	imparcial
impetus	ímpeto
implicate, imply	implique
import	importação
important, serious	categorizado
impose	imponha
imposing	impo
impossible	impossível
impossibly	impossìvel
impress	imprima
impression	impressão
improve	melhore
impulse, push	impulso
in vain	debalde
inch	polegada
including	incluir
inclusive	inclusivo
inclusively	inclusiva
income, render	renda
incomplete	incompleto
incorrect	incorreto
increase, raise	aumento
increasingly	cada vez mais
indent	recorte
index	índice
India	India
indicate	indique
indicate, point out, show	mostrar
indication, statement	indicação
indicative	indicativo
indifferent	indiferente
Indonesia	Indonésia
induce	induza
industrialist	industrialista
industry	indústria
inert	inerte
infant	infante
infantry	infantaria
infection	infecção
inflate	infle
inflated	inflado
inflation	inflação
influence	influência
inform	informe
information	informação
inhabitant	habitante
inherit	herde
inhibit	iniba
inhuman	inumano
initial	inicial
inject	injete
injection	injeção
injure	fira
injured, wounded	ferido
injury	ferimento
injury, wound	ferida
ink	tinta
inner, internal	interno
innocent	inocente
inoculate	inocule
inquiry	inquérito
inquiry-office	inquérito-escritório
insane	insano
insert	inserção
inside, inwards	para dentro
insignificant	insignificante
insinuate	insinue
insist	insista
insist	insistir
inspect	inspecione
inspection	inspeção
inspiration	inspiração
inspiring	inspirar
install	instale
instalment	prestação
instinct	instinto
institute	instituto
institution	instituição
instruct	instrua
instructor	instrutor
instructor, teacher, master	mestre
insulate	isole
insulation, isolation	isolação
insulator	isolador
insult	insulto
insurance, safe, secure	seguro
insure	segure
intellectual	intelectual
intelligence	inteligência
intend	pretenda
intend, mean	tencionar
intense	intenso
intention	intenção
intentional	intencional
intercede	interceda
interchange	intercâmbio
interesting	interessar
interface, relation	relação
interference	interferência
intermittent	intermitente
international	internacional
interpret	interprete
interpretation	interpretação
interpreter	intérprete
interval	intervalo
intervene	intervenha
interview	entrevista
introduce	introduza
introduce, perform, present	apresentar
introduction	introdução
invade	invada
invasion	invasão
invent	invente
invention	invenção
inventory	inventário
investigate	investigue
investigation	investigação
investigation, examination, test, audit	exame
invitation	convite
invite	convidar
invite	convide
invoke	invoque
iodine	iodo
Iran	Irã
Ireland	Irlanda
Iris	Íris
Irishman	irlandês
iron	ferro
iron	férreo
island	console
island	ilha
isolated	isolado
Israel	Israel
Istanbul	Istambul
Italian	Italiano
Italy	Itália
its, their, your, yours	seu
ivory	marfim
jack	jaque
jack, ape, monkey	macaco
jacket	jaqueta
jail, gaol, prison	cadeia
jail, gaol, prison	cadeio
jail, gaol, prison	prisno
jam	atolamento
jam, marmelade	compota
Jamaica	Jamaica
January	Janeiro
Japan	Japão
Japanese	Japonês
jargon	jargão
jaw, jawbone	maxila
jaw, jawbone	queixada
jaws	maxilas
jerk	empurrão
jewel	jóia
jeweller	joalheiro
job, assigned job, task	tarefa
job, work, job-, labour	trabalho
jog, motion, move, movement	movimento
Johannesburg	Joanesburgo
join	junte
joining	juntar
joke	gracejo
jolt	sacudida
Jordan	Jordão
journalist, female journalist	jornalista
journey, voyage	viagem
joy	alegria
joystick	manche
judge	juiz
judgment	julgamento
jug, pitcher	jarro
juice	suco
July	Julho
June	Junho
jungle	selva
junior	júnior
jury	júri
justice	justiça
kaleidoscope	caleidoscópio
kangaroo	canguru
kangaroo	canguru
kangaroos	cangurus
karate	carate
karma	carma
kayak	caiaque
keel	quilha
keen, sharp	afiado
keep	fortaleza
keep	sustento
keep, mind, observe	observar
keep, save, rescue	poupar
keg	barril
kennel	canil
kernel, seed	semente
kerosene	querosene
kerosene	querosene
kettle	chaleira
key	chave
key, wrench	chave
keyboard	teclado
keyboard	teclado
keyhole	fechadura
keys	chaves
kick	chute
kick	pontapé
kid	cabrito
kid	garoto
kid	miúdo
kidney	rim
kill	matança
kill, liquidate, slay	matar
kilometer, kilometre	quilômetro
kind	amável
kind, sort	género
kind, sort, species	espécie
kindle, light	acender
kindness	bondade
king	rei
kingdom, realm, reign	reino
kiss	beijar
kiss	beijo
kitchen	cozinha
kitten	gatinho
knee	joelho
kneel	genuflexão
knife	faca
knob	botão
knock	batidas
knot, node	nó
know	saiba
know, know how	saber
knowledge, acquaintance	conhecimento
Korea	Coreia
label	etiqueta
label, sticker	etiqueta
labelable	etiquetável
labeled	etiquetado
labeler	etiquetador
labelers	etiquetadores
labels	etiquetas
labial	labial
labialization	labialização
labialize	labializar
labialized	labializado
labially	de forma labial
laboratories	laboratórios
laboratory	laboratório
laboratory	laboratório
labour-union	trabalh-união
lace, loop, shoe-lace, tie	laço
lack, miss, shortage	falta
lacquer	laca
ladder, stair	escada
lady	senhora
lady	senhora
lagoon, pond	lagoa
lamb	cordeiro
landing	aterragem
landing-stage	aterragem-estágio
landmark	marco
landscape	paisagem
lane	pista
language, tongue	linguagem
language, tongue	língua
lantern	lanterna
lap	regaço
lapse	lapso
lapsed	decorrido
larder, pantry, store-cupboard	aparador
lark	cotovia
last	último
lasting	durar
lately	ultimamente
lathe	torno
laugh	rir
laughter, laugh	riso
launch	lançamento
laundry	lavanderia
laurel	loureiro
law	lei
lawn	gramado
lay down, place, put, put down	colocar
lay down, place, put, put down	meter
lay down, place, put, put down, by, per	por
lay-by	coloc-por
layer	camada
lazy	preguiçoso
lead	chumbo
leader	líder
leading	conduzir
leaf, sheet	folha
leap	pulo
leap-year	pul-ano
learn	aprenda
learn	aprender
learned	instruído
learnt	aprendido
lease, rent	aluguel
least, less	menos
leather	couro
leave, licence, permit	licença
leaving-certificate	leaving-certificado
Lebanon	Líbano
lectern	atril
left	esquerdo
leg	perna
legend	legenda
legendary	legendário
lemon	limão
lemonade	limonada
lend	emprestar
lend	empreste
length	comprimento
lengthen	alongue
lengthwise	longitudinalmente
lens	lente
lentil	lentilha
leopard	leopardo
lesson	lição
let	deixado
letter	carta
letter	letra
lettuce	alface
level	nível
level-crossing	nível-cruzamento
library	biblioteca
Libya	Líbia
lie	mentira
lieutenant	tenente
life	vida
light	luz
light-switch	comutador
light-switch	luz-interruptor
lighter	mais claro
lighthouse, headlamp, headlight	farol
lightly	levemente
lightning	relâmpago
like this, so, that way, thus	assim
like this, so, that way, thus	tal
like this, so, that way, thus	tão
like this, so, that way, thus, such	tais
likely, probably	provavelmente
lily	lírio
limb, member	membro
lime	cal
lime-tree	cal-árvore
lime-tree, linden-tree	tília
limited	limitado
linden-tree	linden-árvore
line, thread	linha
line, wire	fio
linen	linho
lineseed-oil	lineseed-óleo
linguist	lingüista
linguistic	lingüístico
lining	forro
lion	leão
lip	lábio
lip, maple	bordo
liquor	licor
Lisbon	Lisboa
lisp	cicie
listen	escutar
listen	escute
listener	ouvinte
liter, litre	litro
literary	literário
literature	literatura
litigate	litigue
little	pouco
lively	vívido
liver	fígado
livestock	animais domésticos
living room	sala
loan	empréstimo
loathe	deteste
lobster	lagosta
locate	localize
location, position	posição
lock	fechadura
lock	fechamento
locks	fechaduras
locomotion	locomoção
locomotion	movimento
locomotive	locomotiva
locust	gafanhoto
locust	locustídeo
locusts	gafanhotos
logic	lógica
logical	lógico
London	Londres
long	comprido
long	por muito tempo
look	olhadela
loom	tear
loose	frouxo
loosely	frouxamente
lord	senhor
Lorraine	Lorena
lose	perca
lose	perder
lost	perdido
lot, plot	lote
loud	ruidosamente
loudly	alta
louse	piolho
love	amo
love	amor
loveable	amoroso
lovely	encantador
lovely	lindo
lover	amante
loving	amoroso
low tide	baixamar
low, bass	baixo
lower	mais baixo
loyal	leal
luck, sort	sorte
luggage-van	bagagem-camionete
luggage-van	furgão
lukewarm, warm	morno
lump	protuberância
lung	pulmão
luxury	luxo
ma	mamae
ma'am	senhora
macabre	macabro
macadam	asfalto
macadamize	asfaltar
macadamized	asfaltado
macadamizes	asfalta
macadamizing	asfaltando
macaque	macaco
macaroni	macarrão
macaw	arara
macaws	araras
Macedonian	Macedónio
macerate	macerar
machete	facão
machete	machete
machine	máquina
machine	máquina
machinery	maquinaria
machinery	maquinário
machines	máquinas
machismo	machismo
macho	macho
mackerel	cavala
macro	macro
macrocosm	macrocosmos
macroeconomic	macroeconomia
macroinstruction	macroinstrução
mad	louco
madam	madame
madam	senhora  
madness	loucura
magic	mágica
magic	mágico
magical	mágico
magical, magician	mágico
magna	magna
magnet	ímã
magnetic	magnético
magnetism	magnetismo
magnificent	magnífico
maid	empregada
maid	empregada doméstica
maid, servant	criada
mail, post	correio
mailbox	caixa postal
main, major	principal
maintain	mantenha
majestic	majestoso
majority	maioria
make	faça
malaria	malária
male	macho
malfunction	mau funcionamento
Malian	Maliense
malicious	malicioso
malign	caluníe
mammal	mamífero
management	gerência
manager	gerente
mandate	mandato
maneuver, manoeuvre	manobra
mango-tree	mango-árvore
manifest	manifesto
manipulate	manipule
mankind	humanidade
manner, mode, way	maneira
manner, mode, way, mood	modo
mantel	cornija de lareira
manufacture	manufatura
manuscript	manuscrito
many	muitos
manuvre	manuvre
map	mapa
marble	mármore
March	Março
mark	marca
mark, sign, signal, token	aceno
market, marketplace	mercado
marriage	matrimónio
marriage, union	união
married	casado
marry	case
marry, be married, get married	casar-se
Mars	Marte
marsh	pântano
marvel, wonder	maravilha
mask, shade	máscara
mass	massa
massive	maciço
mast	mastro
mat	esteira
match	fósforo
match-make	fósforo-faça
match-maker	fósforo-fabricante
mathematical, mathematician	matemático
mathematics	matemática
matrix	matriz
matter	matéria
mattress	colchão
mature, ripe	maduro
Mauritania	Mauritânia
maximum	maximo
maximum	máximo
May	Maio
may	possa
maybe, perhaps, possibly	acaso
maybe, perhaps, possibly	talvez
me	mim
meal	refeição
mean	média
mean	médio
mean	significar
meaning	significado
meaningful	com significado
meaningless	sem sentido
meaningless	sem significado
meanings	significados
means	significa
means, tool	ferramenta
meantime	entretanto
meanwhile	entrementes
meanwhile	entretanto
measles	sarampo
measles	sarampo
measurability	mensurabilidade
measurable	mensuravel
measure	medir
measure, measurement	medida
measured	medido
measured	medido
measureless	sem medida
measurement	medicao
measurements	medicoes
measurer	medidor
measures	medidas
meat	carne
mechanic	mecânico
mechanic, mechanical	mecânico
mechanical	mecânico
mechanics	mecânica
mechanics	mecânicos
medal	medalha
medicine	medicina
Mediterranean	Mediterrâneo
meet, meeting	reunião
melancholy	melancolia
melody	melodia
melon	melão
melt, melting	derretimento
membership, society	sociedade
memory	memória
menace, threat	ameaça
mend	emende
menu, list	lista
merchandise	mercadoria
merchant	comerciante
Mercury	Mercúrio
mere	mero
merit	mérito
mermaid	sereia
mermaids	sereias
merry	alegre
merry	feliz
mesh	engranzamento
message	mensagem
messenger	mensageiro
metal	metal
metallic	metálico
meteorology	meteorologia
meter, metre	medidor
method	método
methodical	metódico
metric	métrico
Mexican	Mexicano
Mexico	México
microbe	micróbio
microfilm	microfilme
microphone	microfone
microscope	microscópio
midday, noon	meio-dia
middle	médio
Middle East	Médio-Oriente
midge-bite	midge-mordida
midnight	meia-noite
midnight	meia-noite
migrant	emigrante
migrate	migre
mile	milha
milestone	marco miliário
military	militar
milk	leite
mill	moinho
miller	moleiro
millimeter, millimetre	milímetro
milliner	modista
million	milhão
mind	mente
mine	mina
miner	mineiro
minimum	mínimo
mining	mineração
mining-engineer	mining-coordenador
minister	ministro
ministry	ministério
mint	hortelã
mint-master	mint-mestre
minus, negative	negativo
minute	minuto
minutes	minutos
mirror	espelho
miscarry	fracasse
miserable	miserável
miserable, poor	pobre
miserably	miseràvel
misery	miséria
misfortune	infortúnio
mission	missão
missionary	missionário
misunderstand	entenda mal
misunderstanding	engano
mite	ácaro
miter	mitras
mitre	mitra
mnemonic	mnemônica
mobile	móbil
mode	modalidade
model	modelo
moderate	moderado
modern, up-to-date	moderno
modest	modesto
modify	modifique
mole	toupeira
molecule	molécula
moment	momento
momentarily	momentaneamente
momentary	momentâneo
Monday	Segunda-feira
money, cash	dinheiro
money-box	dinheiro-caixa
monkey-wrench	macaco-chave
monopoly	monopólio
month	mês
monthly	mensal
monthly	mensalmente
monument	monumento
moon, moon-	lua
Moor	Amarre
morality, vice	virtude
morals	morais
morning	manhã
Morocco	Marrocos
morpheme	morfema
morphology	morfologia
mortar	almofariz
Moscow	Moscovo
Moslem, Muslim	Muçulmanos
mosquito, gnat	mosquito
mosquito-net, mosquito-netting	mosquito-rede
moss	musgo
moss-green	musgo-verde
most	a maioria
mostly	na maior parte
moth	traça
mother	mãe
motive	motriz
motor-launch	motor-lance
motorcycle	motocicleta
mount, mounting	montagem
mountain	montanha
mountain, saw	serra
mouse, rat	rato
mouse-trap	rato-prenda
moustache	bigode
mouth	boca
mouth	foz
movie	filme
moving	mover-se
Mr	Sr.
Mr.	Sr..
muck-water	muck-água
mud	lama
mud	lodo
muddy	enlameado
mulberry-tree	amoreira
mulberry-tree	mulberry-árvore
mule, hinny	mula
multinational	multinacional
multiple	múltiplo
multiply	multiplique
murder	assassinato
muscle	músculo
museum	museu
mushroom	cogumelo
music	música
music-book	música-livro
music-box	música-caixa
music-lesson	música-lição
music-lover	música-amante
music-stand	música-esteja
musical-box	musical-caixa
musician	músico
musk-deer	musk-cervos
musk-ox	musk-boi
mussel	mexilhão
mussel-bank	mexilhão-banco
mussel-bed	mexilhão-cama
must, obligation	obrigação
mustard	mostarda
mustard-gas	mostarda-gás
muster-roll	agrup-role
mutton	carne de carneiro
mutual	mútuo
muzzle	açaime
my	meu
myriad	miríade
myself	eu mesmo
mysterious	misterioso
mystery	mistério
myth	mito
nag	aborrecer
nail	prego
nail	prego
nail	unha
nail-bed	prego-cama
nail-brush	prego-escove
nail-scissors	prego-tesoura
nail-varnish	prego-envernize
nails	pregos
naive	ingénuo
naked	despido
naked	nu
naked	pelado
name	nome
name-day	nome-dia
name-plate	placa de identificação
namely	a saber
namely	nomeadamente
names	nomes
Namibia	Namíbia
naming	nomear
nanny	ama
nanogram	nanograma
nanograms	nanogramas
nanosecond	nanosegundo
nanoseconds	nanosegundos
nap	sesta
nap	sesta
naphtha	nafta
napkin	guardanapo
napkin	guardanapo
napkins	guardanapos
Naples	Nápoles
nappies	fraldas
nappy	fralda
narcissism	narcisismo
narcotic	narcótico
narrate	narrar
narrated	narrado
narrative	narrativa
narrator	narrador
narrow	estreito
nasty	malévolo
nation	nação
national	nacional
nationality	nacionalidade
native	nativo
native	nativo
natives	nativos
naturally	naturalmente
nature	natureza
navigation	navegação
navy	marinha
near	perto
near-sighted	próximo-avistado
nearby	próximo
nearer	mais próximo
nearest	o mais próximo
neat, pure	puro
necessary	necessário
necessary, precise	preciso
necessity, need	necessidade
neck	pescoço
nectar	néctar
needle	agulha
negatively	negativamente
neglect	negligência
negotiate	negocie
neighbor, neighbour	vizinho
neighborhood, neighbourhood, vicinity	vizinhança
neither	nem
neither, none	nenhuns
neon	néon
nephew	sobrinho
Neptune	Netuno
nerve	nervo
nervous	nervoso
net, network	rede
neutral	neutro
never	jamais
never	nunca
nevertheless	não obstante
new, novel, young	novo
news	notícia
nibble	mordidela
Nicaragua	Nicarágua
niece	sobrinha
Nigeria	Nigéria
night-attire	noite-night-attire
night-blind	noite-cego
night-blindness	noite-night-blindness
night-duty	noite-dever
night-frost	noite-geada
night-lamp	noite-lâmpada
night-moth	noite-traça
night-service	noite-serviço
night-train	noite-treine
night-watch	noite-preste atenção
nightingale	rouxinol
Nile	Nilo
nine	nove
nineteen	dazanove
nineteen	dezenove
ninth	nono
nip	estreitamento
nipple, nozzle	bocal
nit-picker	nit-nit-picker
no	No.
No	Não
no, not	não
no-one's	no-one
noble	nobre
nobody, no-one	ninguém
nod	assentimento
noiseless, silent	silencioso
noisy	ruidoso
nonsense	absurdo
norm	norma
Norman	Normando
north, North	norte
northern	do norte
Norway	Noruega
Norwegian	Norueguês
nose	nariz
nostril	narina
notary	notário
note	nota
notebook	caderno
nothing, damn	nada
notice, observation, remark	observação
notice-board	observação-placa
notification	notificação
notify	notifique
notion	noção
nought, zero, null	zero
noun, substantive	substantivo
novel	novela
November	Novembro
now, well, well then	pois
nowadays	hoje em dia
nowhere	em nenhuma parte
number	número
nurse	enfermeira
nut, sow	porca
nut, walnut	noz
nuts	porcas
o'clock	horas
O.K.	APROVE.
oak	carvalho
oak	carvalho
oar	remo
oar	remo
oasis	oásis
oat	aveia
oath	juramento
oath	juramento
oatmeal	farinha de aveia
oatmeal	mingau de aveia
oats	aveia
obedience	obediência
obelisk	obelisco
obese	obeso
obesity	obesidade
obey	obedecer
obey	obedeça
obfuscate	ofuscar
object	objeto
objectionable, unpleasant	desagradável
obliging	obrigar
obscure	obscuro
obstacle	obstáculo
obstruct	obstrua
obtain, procure	obtenha
obtainable	obtenível
obvious	óbvio
obviously	obviamente
occasion	ocasião
occasional	ocasional
occupation	ocupação
occupy	ocupe
occupy, take	ocupar
occur	ocorra
ocean	oceano
October	Outubro
octopus	polvo
odd	impar
odour	odor
offensive	ofensivo
officer, official	funcionário
officer, official	oficial
offspring	prole
often	frequentemente
oil	azeite
oil	óleo
OK	APROVAÇÃO
OK, okay, well	bem
okay	aprovação
old maid	solteirona
old, stale	velho
older	mais velho
olive	azeitona
olive-tree	azeitona-árvore
olive-tree	oliveira
omit	omita
omitted	omitido
once	uma vez que
one	um
one	uma
one-way traffic	mão-única
onion	cebola
open	aberto
open, open up	abrir
openly	abertamente
opera	ópera
operate	opere
operation	operação
operative	operativo
Oporto	Porto
opponent	oponente
opportunity	oportunidade
oppose	oponha
opposite	oposto
opposition	oposição
optician	oculista
option	opção
or	ou
orally	oral
orange	alaranjado
orange	laranja
orange-tree	alaranjado-árvore
orange-tree	laranjeira
orbit	órbita
orchard	pomar
ordinarily	ordinariamente
organ	órgão
organ-grinder	órgão-moedor
organic	orgânico
organism	organismo
organization	organização
orient	oriente
origin	origem
originally	originalmente
originate	origine
oscillate	oscile
oscillation	oscilação
oscillator	oscilador
oscilloscope	osciloscópio
ostrich	avestruz
other, another, else	outro
ounce	onça
our	nosso
ours	nossos
out	para fora de
outer	exterior
outfit, set, suit	terno
outfit, set, suit, fact	fato
outside	fora
outstanding	proeminente
outward	para fora
oven	forno
overall, utter	total
overalls	macacões
overdrive, override	ultrapassagem
overflowing	transbordar
overhaul, review, revise	revisão
overhead	aéreo
overlay	folha de prova
overlook	negligencie
overture	insinuação
overwhelm	oprima
owe, shall	deva
owl	coruja
owl	mocho
own	para possuir
own, personal, itself	próprio
own, possess	possuir
owner	dono
owner	proprietário
ownership	posse
ox, steer	boi
oxygen	oxigênio
oyster	ostra
ozone	ozônio
pace	andar a passo
pace	passear
pace, rhythm	ritmo
pacemaker	marca-passos
pacific	pacato
Pacific	Pacífico
pacification	pacificação
pacifier	chupeta de bebê
pacifies	pacifica
pacifist	pacifista
pacify	pacificar
pack	embalar
package	fardo
packaged	embrulhado
packages	pacotes
packed	embrulhado
packer	empacotador
packet, parcel, bundle, package	pacote
paddle, spade	pá
paddy-field	paddy-campo
page	página
pager	bíper
pail	balde
pain	dor
painful	doloroso
painless	indolor
paint, painting	pintura
paintbrush	pincel
painter	pintor
pair, peer	par
Pakistan	Paquistão
palace	palácio
pale	pálido
Palestine	Palestina
palm	palma
pamphlet	panfleto
Pan, tray	Bandeja
Panama	Panamá
panel	painel
panel	painel
panic	pânico
panther	pantera
pantry	despensa
pants, trousers	calças
paper, role	papel
paper-basket	papel-cesta
papers	papeis
parachute	paraquedas
parachute	pára-quedas
parachuter	paraquedista
paradigm	paradigma
paradise	paraiso
paradoxical	paradoxo
paraffin	parafina
paraffin-oil	parafina-óleo
paraffin-oil, petroleum	petróleo
paragraph	parágrafo
paragraph	parágrafo
Paraguay	Paraguai
parallax	paralaxe
parallel	paralela
parallel	paralelo
paralyse	paralize
paralysed	paralizado
parameter	parâmetro
parenthesis	parêntese
parents	pais
parity	paridade
park	parque
parliament	parlamento
parrot	papagaio
parsley	salsa
part, piece, share	parte
partial	parcial
partially	parcialmente
participate	participe
particle	partícula
partition	divisória
partly	em parte
partridge	perdiz
party	partido
passenger	passageiro
passenger train	mixto
passer-by	transeunte
passion	paixão
passport	passaporte
past	após
pastor	sacerdate
pastor, cure	cura
patch	remendo
patent	patente
path	caminho
path	trajeto
patience	paciência
patient	paciente
patrol	patrulhe
pattern	teste padrão
pause	pausa
pave	pavimente
pavement	pavimento
pavement, sidewalk	calçada
pavement, sidewalk, ride	passeio
pawn	penhor
pawn	peão
pawns	peões
pay	pagar
pay out, spend	gastar
pay, payment	pagamento
pea	ervilha
peace	paz
peaceful	calmo
peach	pêssego
peak	pico
peanut	amendoim
pear	pera
pear	pêra
pear-tree	pera-árvore
pear-tree	pereira
pearl	pérola
peasant	camponês
Peiping, Peking	Pequim
pen-knife	canivete
pencil	lápis
pending	pendente
penetrate	penetre
peninsula	península
penny	moeda de um centavo
pepper	pimenta
percent	por cento
percentage	porcentagem
perfect	perfeito
perfection	perfeição
perform	execute
perimeter	perímetro
period, spell	período
periodical	revista
peripheral	periférico
periphery	periferia
permanent	permanente
permission	permissão
Persian	Persa
persist	persista
persistent	persistente
person	pessoa
personality	personalidade
personnel, personal	pessoal
persons	pessoas
perspiration	perspiração
persuade	persuada
pestle	pilão
pet	animal de estimação
petal	pétala
petition	abaixo-assinado
petition	petição
petition	petição
phase	fase
phenomenon	fenômeno
Philippines	Filipinas
philosopher	filósofo
philosophy	filosofia
phoenix	fénix
phonetic	fonético
phonograph	fonógrafo
photograph, photography	fotografia
photographer	fotógrafo
physical	físico
physics	física
pick	picareta
picnic	piquenique
picture, portrait	retrato
picture-frame	retrato-frame
picturesque	pitoresco
pie	torta
piece of furniture, mobile	móvel
pier, wharf	cais
pig	porco
pike	lúcio
pike	pique
pillow, pad	almofada
pillow, rest	descanso
pilot	piloto
pin	pino
pin, needle	alfinete
pincers, pair of pincers	tenazes
pine	pinho
pine, pine tree	pinheiro
pine-apple, pineapple	abacaxi
pine-apple, pineapple	ananás
pink	cor-de-rosa
pioneer	pioneiro
pipe	cachimbo
pipe	tubulação
pirate	pirata
pistol	pistola
piston	pistão
pit, well	poço
pit-props	poço-suportes
pity	piedade
pivot	pivô
placard	cartaz
place	lugar
place	sítio
place, site	local
plain	planície
plane	plaina
plane	plano
plane, aeroplane, airplane, air-plane, aircraft	avião
planet	planeta
planetary	planetário
plank	prancha
plantation	plantação
planting	plantar
plaster	emplastro
plastic	plástico
plateau	platô
platform, quay, wharf, deck	plataforma
platoon	pelotão
play	jogar
play	tocar
plaza, square, public square	adro
plaza, square, public square	praça
please	agradar
please	por favor
pleasing	satisfazer
plough	arado
pluck	arranque
plug	plugue
plum	ameixa
plunder	pilhagem
plunder, rob	roubar
plus, positive	positivo
plywood	madeira compensada
pocket	algibeira
pocket	bolso
poem	poema
poet	poeta
poetic	poético
poetry	poesia
poison	veneno
poisonous	venenoso
Poland	Polónia
Poland	Polônia
Pole	polaco
pole	pólo
police	polícias
police-station	polícia-estação
policeman	polícia
policy, politics	política
polish	lustrador
polite	polido
political, politician	político
pond, lake	lago
pony	pônei
poop, poopdeck, stern	popa
pope	papa
poplar	álamo
population	população
pork	carne de porco
portable	portátil
porter	porteiro
porter, boot	carregador
porthole	vigia
Portugal	Portugal
Portuguese	português
positively	positivamente
possess	possua
possession	possessão
possessions	possessões
possible	possível
possibly	possivelmente
post	borne
post-paid	borne-pago
postage	porte
postage	porte postal
postman	carteiro
postulate	postulado
pot	potenciômetro
pot, chamber-pot	penico
pot-pourri	potenciômetro-pourri
potato	batata
pottery	cerâmica
poultry	aves domésticas
pound sterling, pound	libra
pour	derrame
pour	pour
poverty	pobreza
power	poder
powerful	poderoso
practical	prático
practice	prática
practise	pratique
Prague, plague	praga
prairie	pradaria
prawn	camarão grande
pre-fabrication	pre-fabricação
precede	preceda
precision	precisão
prefer	preferir
prefer	prefira
preferably	preferivelmente
preferably, else, more	mais
prefix	prefixo
pregnant	grávido
prejudice	preconceito
preliminary, primary	preliminar
premium, upper	superior
preparation	preparação
preparatory	preparatório
prepay	pag antecipadamente
preposition	preposição
prescription	prescrição
presence	presença
presentation	apresentação
press	imprensa
pressing	pressionar
prestigious	prestigioso
presume	presuma
presumption	presunção
pretty	lindo
prevent	impeça
previous	precedente
previously, prior	previamente
price	preço
price-list	preço-lista
pride	orgulho
primitive	primitivo
prince	príncipe
princess	princesa
printer	impressora
prism	prisma
prison	prisão
prisoner	prisioneiro
private	confidencial
privilege	privilégio
privileged	privilegiado
prize	prêmio
probable	provável
probably	provávelmente
problem, trouble	problema
procedure	procedimento
proceed	prosiga
process	processo
procession	procissão
proclaim	proclame
procrastinate	procrastine
product, produce	produto
production	produção
profess	professe
profession	profissão
professional	profissional
profile	perfil
profit	lucro
profound	profundo
program, programme	programa
progress	progresso
prohibit	proíba
projector	projetor
proletarian	proletário
prolonged	prolongado
promise	promessa
promote	promova
prompter	mais alerta
promulgate	promulgue
pronounce	pronuncie
pronunciation	pronunciação
proof, sign, token	prova
properly	corretamente
proportion	proporção
proportional	proporcional
proposal	proposta
propose	proponha
prose	prosa
prosperity	prosperidade
protect	proteger
protect	proteja
protection	proteção
protein	proteína
protest	protesto
protocol	protocolo
prototype	protótipo
proud	orgulhoso
province	província
provoke	provoque
proximity	proximidade
prune	ameixa seca
Prussia	Prússia
psychological	psicológico
psychologist	psicólogo
psychopath	psicopata
pub, publication	publicação
public	público
publicity	publicidade
publish	publique
publisher	editor
pudding	pudim
pug-dog	pug-cão
pug-nose	pug-nariz
pulley	polia
pulsate	pulse
pump, bomb	bomba
punch	perfurador
punctuation	pontuação
punish	puna
punishment	punição
puppet	fantoche
purchase, buy	compra
purge	remoção
purity	pureza
purple	púrpura
purple	roxo
purpose	finalidade
purse	bolsa
purse, wallet	bolsa
pursue	persiga
push-button	de botão de pressão
pussy	bichano
put	posto
puzzle	enigma
pyramid	pirâmide
Pyrenees	Pirinéus
quail	codornizes
qualification	qualificação
quality	qualidade
quantity	quantidade
quarters	quartos
queen	rainha
question	pergunta
questionable	questionável
quick, quickly, swiftly	rapidamente
quietly	quietamente
quit	parado
quotation	citação
quote, quotes	citações
rabbit	coelho
rabbit	coelho
rabbits	coelhos
race	corrida
racial	racial
racism	racismo
racist	racista
radar	radar
radial	radial
radiator	radiador
radically	radical
radio	radio
radio	rádio
radish	rábano
radius, ray	raio
raft	jangada
ragout, stew	guisado
rail	trilho
railroad, railway	estrada de ferro
railroad, railway	ferrovia
rain	chover
rain	chuva
rainbow	arco-íris
raincoat	impermeável
rake	ancinho
ranch	rancho
rancher	rancheiro
random	aleatório
rare	raro
rasp	grosa
raspberry	framboesa
rat-poison	rato-veneno
rate	taxa
rational	racional
rattle	chocalho
raven, crow	corvo
razor-blade	lámina
razor-blade	razor-lâmina
react	reaja
reaction	reação
read	ler
read	lido
reader	leitor
reality	realidade
rear-lamp	traseiro-lâmpada
rear-light	traseiro-luz
reason	razão
reasonable	razoável
rebellion	rebelião
recall	recordação
receipt	recibo
receive	receba
recent	recente
recently	recentemente
reception-room	recepção-quarto
recess	rebaixo
recipe	receita
recipient	receptor
reciprocal	recíproco
reclaim	recuperação
recollect, remember	recorde
recommendation	recomendação
recommended	recomendado
record	registro
record, register	registar
records	registros
recover	recupere
recruit	recruta
red	vermelho
reduce	reduza
reed, tongue	lingüeta
reef	recife
reference	referência
refined	refinado
refinery	refinaria
reflect	refleta
reflection	reflexão
reform	reforma
refresh	refresque
refreshing	refrescar
refrigerator	refrigerador
refuge	refúgio
refusal, refuse	recusa
refuse, reject	recusar
regard	consideração
region	região
register	registo
registered	registado
regret	pesar
regularly	regularmente
regulate	regule
regulation	regulamento
regulations	regulamentos
reject	rejeição
rejection	rejeção
relate	relacione
related	relacionado
relationship	relacionamento
relative	relativo
relative, female relative	parente
relatively	relativamente
relax	relaxe
release	libere
relevance	relevância
reliable	de confiança
religion	religião
religious	religioso
relinquish	abandone
remain	remanesça
remain, stay, stay over	ficar
remainder, remaining	restante
remarkable	notável
remedy	remédio
remind	lembre
remittance	remessa
remote	remoto
remotely	remotamente
removable	removível
remove	remova
renew	renove
rennet-stomach	rennet-estômago
renounce	renuncíe
repay	reembolse
repayment	reembolso
repeat	repetir
repeatedly	repetidamente
repetition	repetição
replace	replacao
replace	substitua
replacement	recolocação
report	relatório
repose, rest	descansar
represent	represente
representation	respresentação
representative	representante
reproach	reprimenda
reproduce	reproduza
reproduction	reprodução
reptile	réptil
republic	república
republican	republicano
repulse	repulsa
reputation	reputação
request	pedido
require	reque
requisition	requisição
rescue	salvamento
research	pesquisa
resemblance	semelhança
resemble	assemelhe-se
reserve	reserva
residence	residência
resign	renuncie
resignation	renúncia
resin	resina
resist, withstand	resistir
resistance	resistência
resonance-box	resonance-caixa
respectable	respeitável
respective	respectivo
respond	responda
responsibility	responsabilidade
responsible	responsável
restaurant	restaurante
resting-place	resting-lugar
restrain	contenha
restrict	restrinja
restricted	restrito
result	resultado
retailer	varejista
retain, withhold	retenha
retarded	retardado
retire	aposente
retired, retiree	aposentado
retirement	aposentadoria
retreat	recuo
return	retorno
return-ticket	retorn-bilhete
reveal	revele
revenge	vingança
reverse	reverso
reversed	invertido
revolt	revolta
revolution, turn	volta
revolutionary	revolucionário
revolver	revólver
Rhine	Reno
Rhine-barge	Rhine-barca
Rhine-wine	Rhine-vinho
rhinoceros	rinoceronte
Rhodesia	Rodésia
rhyme	rima
rhythmic	rítmico
rib	costela
rib	reforço
ribbon	fita
rice	arroz
rice-field	arroz-campo
rich, wealthy, well-off	rico
rid	livrado
rider	cavaleiro
right	direita
right-hander	direito-hander
rigid	rígido
ring	anel
rinse	enxaguadura
riot	motim
rip, tear	rasgo
rising	levantar-se
river	rio
rivet	rebite
road, route, way, highway	estrada
road-metal	estrada-metal
roam, wander	vagueie
roar	rugido
robber	salteador
robe, vest	veste
robot	robô
rock	rocha
rocket	foguete
rod, stem	haste
rodent	roedor
roll	pãozinho
roll, roller	rolo
roller-blind	persiana
roller-blind	rolo-cego
Roman	romano
Romania, Rumania	Roménia
Romania, Rumania	Ruménia
romantic	romântico
Rome	Roma
roof	telhado
root	raiz
rose	levantou-se
rose	rosa
rose-bush	levant-arbusto
round	redondo
route	rota
routine	rotina
row	fileira
row	remar
row-boat	barco a remos
rowing-boat	rowing-barco
rubber	borracha
ruin	ruína
rule, ruler	régua
rules	réguas
ruminant	ruminante
rumor, rumour	boato
run	funcionamento
rush	arremetidas
Russia	Rússia
Russian	russo
rust	oxidação
rusty	oxidado
rye	centeio
s	décima nona letra do alfabeto
sabbath	dia de descanso
sabbath	domingo para os Cristãos
sabbath	sabá
sabbath	sábado dos hebreus
saber	sabre
sabers	sabres
sabertooth	dentes-de-sabre
sable	marta zibelina
sable	pele de marta zibelina
sabotage	sabotagem
sabotages	sabotagens
sabotaging	sabotagem
saboteur	sabotador
saccharin	sacarina
saccharose	sacarose
sacerdotal	sacerdotal
sacerdotalism	sacerdotalismo
sacerdotalist	sacerdotalista
sack	saco
sacrament	sacramento
sacramental	sacramental
sacramentalism	sacramentalismo
sacramentalist	sacramentalista
sacramentally	sacramentalmente
sacraments	sacramentos
sacred	sagrado
sacrifice	sacreficar
sacrifice	sacrificar
sacrifice	sacrifício
sacrifice	sacrifício
sacrificed	sacreficado
sacrificed	sacrificado
sacrifices	sacrefícios
sacrifices	sacrifícios
sacrificing	sacramento
sacrilege	sacrilégio
sacrilegious	sacrílego
sad	circunspecto
sad	detestável
sad	escuro
sad	melancólico
sad	sombrio
sad	triste
sadden	contristar
sadden	eescurecer
sadden	entristecer
sadden	tornar mais denso
saddle	sela
saddle	sela
saddle	selim
sadism	sadismo
sadist	sadista
sadistic	sadístico
sadistically	sadisticamente
sadists	sadistas
sadly	tristemente
sadness	tristeza
sadomasochism	sadomasoquismo
sadomasochist	sadomasoquista
sadomasochistic	sadomasoquístico
safe	cofre
safe	salvo
safe	seguro
safeguard	salvaguarda
safeguard	salvaguardar
safeguards	salvaguarda
safekeeping	custódia
safekeeping	salvaguardo
safely	a salvo
safely	em segurança
safely	seguramente
safeness	segurançã
safer	mais seguro
safes	cofres
safest	o mais seguro
safety	segurança
safety, security	segurança
safety-belt	segurança-correia
safety-lamp	segurança-lâmpada
safety-pin	segurança-pino
saffron	acafrão
sag	caída
sag	curva
sag	declinação
sag	dobra
saga	saga
sagacious	sagaz
sage	filósofo
sage	salva
sage	sábio
sage, volley	salva
sage, wise	sábio
sages	sabios
sagging	afundando
sagging	caindo
sago	sagu
Sahara	Saará
said	dito
sail	fazer a` vela
sail	navegar
sail	vela
sail	velejar
sailboat	barco a vela
sailing	marcha do navio
sailing	navegação
sailor	marinheiro
sailor	marinheiro
sailor	navegador
sailors	marinheiros
sailors	navegadores
sails	velas
saint	santa
saint	santo
saints	santas
saints	santos
salad	salada
salad	salada
salads	saladas
salamander	salamandra
salami	salami
salaries	salários
salary	salário
salary, wage	salário
sale	venda
sale	venda
saleable	vendável
sales	vendas
salesgirl	vendedora
saleslady	vendedora
salesman	vendedor
salesmen	vendedores
salespeople	vendedores
salesroom	sala de vendas
saleswoman	vendedora
saleswomen	vendedoras
salient	saliente
saline	salino
saliva	saliva
salivate	salivar
salmon	salmão
salmon	salmão
salmon	salmões
salon	salão
salsa	salsa
salt	sal
salt	sal
saltpeter	salitre
saltwater	água de sal
saltwater	água salgada
salty	salgado
salute	continencia
salute	saudação
salutes	faz continencia
salvage	salvamento
salvaged	salvo
salvation	salvacao
samba	samba
same	mesmo
same	mesmos
sample	amostra
sample	experimentar
sample	provar
sample-bottle	amostra-frasco
sample-card	amostra-cartão
samples	amostras
sanctification	santificacao
sanctified	santificado
sanctifier	santificador
sanctify	santificar
sanctimonious	carola
sanctimoniously	carolamente
sanctity	santidade
sanctuaries	santuarios
sanctuary	santuário
sand	areia
sand	areia
sandwich	sanduiche
sandwich	sanduíche
sandwiches	sanduiches
sandy	arenoso
sardine	sardinha
Sardinia	Sardenha
satellite	satélite
satisfactory	satisfatório
satisfied	satisfeito
satisfy	satisfaça
Saturn	Saturno
saucer	pires
sausage	salsicha
savage, wild	selvagem
save	excepto
say, tell	dizer
scald	escalde
scale	escala
scale	escama
scales	escalas
scan, sweep	varredura
Scandinavia	Escandinávia
Scandinavian	Escandinavo
scar	cicatriz
scene	cena
scenery	cenário
schedule	programação
schedule, time-table	horário
scheme	esquema
school	escola
science	ciência
scientific	científico
scientist	cientista
scissors, shear	tesoura
Scot, Scotsman	escocês
Scotland	Escócia
scrap	sucata
screech-owl	screech-coruja
screw, bolt	parafuso
screwdriver	chave de fenda
scythe	foice
scythe	fouce
sea	mar
sea-bottom	mar-fundo
seagull	gaivota
seal	foca
seam	emenda
seamless	sem emenda
search, seek	busca
seasickness	enjôo
season	temporada
seat	assento
second	em segundo
secondary	secundário
secondhand	de segunda mão
secret	segredo
secretary	secretária
section	seção
sector	setor
see	veja
see	ver
seem	pareça
seize	apreenda
seldom	raramente
semantics	semântica
send	emita
send, transmit	enviar
send, transmit	mandar
sender	remetente
sensitive	sensível
sentence	sentença
separate	separado
separation	separação
September	Setembro
septic	séptico
serial	de série
series	série
serpent, snake	serpente
serve	saque
serve	servir
server, user	usuário
service	serviço
session	sessão
seven	sete
seventeen	dazassete
seventeen	dezessete
seventh	sétimo
seventy	setenta
several	diversos
severe	severo
Seville	Sevilha
sewing-basket	sewing-cesta
sewing-box	sewing-caixa
sewing-class	sewing-classe
sewing-machine	sewing-máquina
sewing-things	sewing-coisas
sewing-thread	sewing-enfíe
sex	sex
sex	sexo
sex	sexo
shade, shadow	sombra
shake	agitação
shallow	raso
shallowly	rasa
share-capital	parte-importante
shareholder	accionista
shark	tubarão
sharp-toned	afiado-sharp-toned
sharpness	agudeza
shaving-brush	shaving-escove
shed	vertente
sheep	carneiros
sheep	ovelha
sheet	lençol
shelf	prateleira
shelf	tábua
shelter	abrigo
shift	deslocamento
shine	brilhar
shine	brilho
shingle, tile	telha
ship, vessel	navio
shirt	camisa
shirt	camisa
shit	merda
shiver	arrepio
shock	choque
shock-absorber	choc-absorvente
shoe	sapata
shoe	sapato
shoe-horn	calçadeira
shoe-lace	atacador
shoe-lift	sapata-levante
shoemaker	sapateiro
shoot	tiro
short	curto
shorten	encurte
shoulder	ombro
show	mostra
shower	chuveiro
shuffle	baralhamento
shut	fechado
shutter	obturador
shy, timid	tímido
Siam	Sião
Siberia	Sibéria
Sicily	Sicília
side	costado
side	lado
side-issue	lado-edição
side-way	lado-maneira
sign	subscrever
sign, signal	sinal
sign-board	sinal-placa
signature	assinatura
significant	significativo
signify	signifique
silence	silêncio
silently	silenciosamente
silhouette	silhueta
silk	seda
sill	peitoril
silver	prata
silver-coloured	prata-colorido
similarity	similaridade
simple	simples
simplify	simplifique
simultaneous	simultâneo
since	desde
sing	cantar
sing	cante
singer	cantador
singer, female singer	cantora
singing-bird	singing-pássaro
single, sole	único
singly	única
sink	dissipador
sister	irmã
sit	sente-se
sitting-room	sitting-quarto
situation	situação
six	seis
sixteen	dazasseis
sixteen	dezesseis
sixth	sexto
sixtieth	sexagésimo
sixty	sessenta
size	tamanho
skate, skid	patim
skeleton	esqueleto
ski	esqui
skillful	hábil
skin, fur	pele
skirt	saia
skull	crânio
slab	laje
slanting	inclinar
slave	escravo
sleep	sono
sleeping-accomodation	sleeping-acomodação
sleeping-car	vagão-leito
sleeping-place	sleeping-lugar
sleeve	manga
slice	fatia
slip	deslizamento
slipper	deslizador
sloping	inclinar-se
slot	entalhe
Slovenian	Esloveno
slow	lento
slowly	lentamente
slug	lesma
smart	esperto
smash	quebra
smear, stain	mancha
smell	cheiro
smile	sorriso
smoke	fumo
smokers	fumadores
smokers	fumantes
snail	caracol
snore	ressono
snow	neve
soak	embeba
soap	sabão
socialism	socialismo
sock	peúga
socket	soquete
Sofia	Sófia
soft	macio
soil	solo
soiled	sujado
solder, weld	solda
soldier	soldado
sole	linguado
sole, plan, plant	planta
solely	unicamente
solo	de solo
solution	solução
Somalia	Somália
somehow	de algum modo
sometimes	às vezes
somewhere	em algum lugar
son	filho
song	canção
soon	logo
soon, early	cedo
soot	fuligem
sophisticated	sofisticado
soul	alma
sound	soar
sound	som
soup	sopa
south	sul
southern	do sul
souvenir	lembrança
Soviet	Soviete
space	espaço
spades	pás
Spain	Espanha
Spaniard, Spanish	Espanhol
spanner	chave de boca
spare	sobressalentes
spark	faísca
sparrow	pardal
speak	fale
speak, talk	falar
specially	especialmente
specific	específico
specify	especifique
specimen	espécime
spectacle	espetáculo
spectacles	espetáculos
spectator	espectador
speech	discurso
speed	velocidade
spend	gaste
spider	aranha
spill	derramamento
spin	rotação
spinach	espinafre
spinning-wheel	spinning-roda
spiral	espiral
spirit	espírito
spirits	espíritos
spiritual	espiritual
spit	cuspo
splash	respingo
splinter	lasca
sponge	esponja
spongy	esponjoso
spontaneous	espontâneo
spool	carretel
sporadic	esporádico
sport	esporte
spread	propagação
spring	mola
spring, springtime	primavera
springboard	trampolim
springtime	primavera
spur	dente reto
spurt	jorros
spy	espião
square	quadrado
squirrel	esquilo
squirt	esguinche
stabilize	stabilizar
stable	estável
stable, stall, sty	estábulo
staff	equipe de funcionários
stag	veado
stage	estágio
stage	palco
stage-manager	estágio-gerente
stain	mancha
stained	manchado
stains	manchas
stair	escada
stairs	escadas
stairs	escadas
stake	estaca
stall	tenda
stammer	gaguejo
stamp, postage stamp, seal	selo
stamp-collecting	carimb-stamp-collecting
stamped	carimbado
stand	carrinho
standard	padrão
standard	padrão
standards	padrões
star	estrela
star	estrela
starboard	estibordo
starboard	estibordo
stare	olhar fixo
stars	estrelas
start	comencar
start	iniciar
starter	acionador de partida
state	estado
state	estado
states	estados
station, season	estação
station-master	estação-mestre
stationer's shop	papelaria
statue	estátua
stay	estada
stay	ficar
steak	bife
steal	robar
steal	roube
steam, vapour	vapor
steam-boiler	vapor-caldeira
steel	aço
steep	íngreme
steering-wheel	steering-roda
stem, trunk, tree-trunk	tronco
stencil	estêncil
stenotypist, female stenotypist	dactilógrafa
stenotypist, female stenotypist	datilógrafa
step	etapa
step-father, stepfather	padrasto
step-mother, stepmother	madrasta
stereo	som
sticky	pegajoso
stiff	duro
still, yet	ainda
stimulate	estimule
stink	fedor
stinking	tresandar
stipulate	estipule
stipulation	estipulação
stock	estoque
Stockholm	Éstocolmo
stocking	meia
stole	roubado
stolen	roubado
stomach	barriga
stomach	estômago
stomachache	dor de barriga
stone	pedra
stone-chippings	pedra-stone-chippings
stone-dead	pedra-inoperante
stoned	drogado
stool	banco
stool	tamborete
stoop	incline
stop	paragem
stop	pare
stopper	bujão
store-cupboard	armazen-armário
stories	estórias
stork	cegonha
storm, tempest	tempestade
story	estória
story, history	história
stout	cerveja de malte
stove	fogão
stove	folgao
stow	armazenagem
straight	em linha reta
strained	esticado
strait	estreito
strange, weird	estranho
stranger	pessoa estranho
stranger, unknown	desconhecido
strangers	pessoas estranhos
strangest	o mais estanho
strangle	estrangule
strategic	estratégico
strategy	estratégia
straw	palha
strawberry	morango
streak	raia
stream	córrego
stream	riacho
stream	ribeiro
stream, brook	ribeiro
streamlined	aerodinâmico
streams	ribeiros
street	estrada
street	rua
street-corner	rua-canto
streetcar, tram	bonde
streets	estradas
strength	forca
strengthen	fortificar
strengthened	fortificado
stress-mark	forç-marca
stretcher	esticador
strict, stringent	estrito
strike	greve
striking	golpear
strip	tira
stripe	listra
stroll	dê uma volta
stroller	carrinho de criança
strong	forte
strong	forte
stronger	mais forte
strongest	o mais forte
struggle	luta
stub	topo
student	estudante
students	estudantes
studio	estudio
studio	estúdio
studios	estudios
study	estudar
study	estudo
stuff	material
stuffy	bofado
stumble	tropeço
stupid	estupido
stupor	estupor
sturdy	resistente
sturdy	seguro
sty	chiqueiro
style	estilo
style	estilo
stylus	estilete
suave	suave
subjective	subjetivo
subjugate	subjugue
subjunctive	subjuntivo
sublime	sublime
submit	submeta
subordinate	subordinado
subscribe	subscreva
subscriber	subscritor
subscription	subscrição
subsequent	subseqüente
subsequently	subseqüentemente
subsidy	subsídio
substance	substância
substitute	substituir
substitute	substituto
substituted	substituido
subtract	subtraia
subtraction	subtração
succeed	lograr
succeed	suceda
success	sucesso
success	sucesso
success	êxito
successes	sucessos
successfully	com sucesso
successor	sucessor
suck	chupar
suck	sugue
suction	sucção
Sudan	Sudão
sudden	repentino
suddenly	de repente
suddenly	de repente
suddenly	subitamente
suffer	sofra
suffice	baste
sufficient	suficiente
sufficiently	suficientemente
suffix	sufixo
suffocate	sufoque
sugar	acucar
sugar	açúcar
sugar-bowl	açúcar-bacia
sugar-palm	açúcar-palma
sugarcane	cana de acucar
suggest	sugira
suicide	suicidio
suit	terno
suitcase	pasta
suitcases	pastas
suits	ternos
sulfur, sulphur	enxôfre
sulfuric, sulphuric	sulfúrico
sultan	sultao
sum	soma
summarize	sumarie
summary	resumo
summer	verão
summer-house	verão-casa
summon	chame
summons	intimação
sun	sol
sun	sol
sundae	sundae
Sunday	Domingo
sunk	afundado
sunlight	luz solar
sunset	por de sol
sunset	por do sol
sunshine	luz do sol
superimpose	sobreponha
supervise	supervisione
supplementary	suplementar
support	sustentação
suppose	suponha
suppose	supor
suppress	suprima
surface	superfície
surgeon	cirurgião
surgery	cirurgia
surgical	cirúrgico
surname	sobrenome
surplus	excesso
surprise	surpresa
surprise	surpresa
surprising	surpreender
surprising	surprendente
surrender	rendição
surround	cerque
surroundings	arredors
survive	sobreviva
survive	sobreviver
surviver	sobrevivente
suspect	suspeito
suspicion	suspeita
sustain	sustente
sustained	sustentado
suture	sutura
swallow	andorinha
swan	cisne
sway, swing	balanço
Swaziland	Suazilândia
swear	jure
sweat	suar
sweat	suar
sweat	suor
sweater	sueter
sweating	suando
Sweden	Suécia
Swedish	Sueco
sweep	varrer
sweet-and-sour	doce-e-sweet-and-sour
swell, swelling	inchamento
swerve	desviar
swift	rápido
swim	nadada
swim	nadar
swimmer	nadador
swimmers	nadadores
swimming-bath	natação-banho
swirl	redemoinho
Swiss	Suíço
switch	interruptor
Switzerland	Suíça
sword	espada
sword	espada
swords	espadas
syllable	sílaba
symbol	simbolo
symbol, token	símbolo
symbolism	simbologia
symbols	simbolos
symmetry	simetria
symphony	sinfonia
symptom	sintoma
syntax	sintaxe
syrup	xarope
system	sistema
systematic	sistemático
T-square	T-quadrado
tab	aba
tab	etiquea
tab	lingueta
tabernacle	tabernáculo
tabernacles	tabernáculos
table	mesa
table	tabela
table, desk	mesa
tablecloth	toalha de mesa
tablecloths	toalhas de mesa
tables	mesas
tablespoon	colher de sopa
tablespoons	colheres de sopa
tablet	lapide
tablet	tabuleta
tablets	lapides
tabloid	tabloide
tabor	a a
tabulation	tabelação
tactic	tática
tactics	táticas
tad-pole	tad-pólo
Tagus	Tejo
tail	cauda
tail	rablo
tailor	alfaiate
tailor	costureira
tailor, female tailor	castuveira
tails	caudas
Taiwan	Formosa
take	tirar
take	tomada
take the place of	substituir
talk	conversa
talk	falar
tall	alto
taller	mais alto
tallest	o mais alto
Tangier	Tânger
tank	tanque
Tanzania	Tanzânia
tape	fita
tape	fita adesiva
tape-recorder	grav-registrador
tapes	fitas
tar	alcatrão
tar	piche
Tasmania	Tasmânia
taste	gosto
tasteless	sem gosto
tattered	esfarrapado
tax	emposto
tax	imposto
taxi	táxi
taxi, cab	táxi
taxi-driver	táxi-excitador
tea	chá
tea	chá
tea-pot	bule
tea-towel	chá-toalha
teach	ensinar
teach	ensinar
teach	ensine
teacher	professor
teacher	professor
teacher, female teacher	mestra
teachers	professores
teachings	ensinamentos
team	time
teams	times
tear	lágrima
tear	rasgar
teardrop	lágrima
tears	lagrimas
tease	arrelíe
technical	técnico
technique	tecnica
technique	técnica
techniques	tecnicas
technological	tecnologica
technology	tecnologia
technology	tecnologia
teeth	dentes
teeth	dentes
telegram	telegrama
telegraph	telégrafo
telemetry	telemetria
telephone	telefone
telescope	telescópio
television	televisao
television	televisão
televisions	televisoes
tell	diga
tell	dizer
temper	têmpera
temperature	temperatura
temperature	temperatura
temple	fontes
temple	templo
temples	templos
temporarily	temporariamente
temporarily	temporariamente
temporary	provisório
temporary	temporario
tempt	tentar
tempted	tentado
tempts	tenta
ten	dez
ten	dez
tendency	tendência
tender	encarregado
tender	tenura
tennis	tênis
tennis	tênis
tension, voltage	tensão
tent	barraca
tent	tenda
tenth	décimo
tenth	décimo
tents	tendas
term	termo
terminate	terminar
terminate	termine
terminology	terminologia
termite	térmita
terms	termos
terms	termos
terrain	terreno
terrestrial	terrestre
terrify	estarreça
territory	território
terror	terror
terrorism	terrorismo
terrorism	terrorismo
terrorist	terrorista
terrorist	terrorista
test	prova
test	teste
testify	testificar
testifying	testificando
testimonies	tesamunhos
testimony	testamunho
tests	provas
text	texto
Thailand	Tailândia
Thames	Tamisa
than	do que
thank	agradecer
thank	agradeça
thank you, thanks	obrigado
thankful	grato
thanks	agradecimentos
that	aquilo
that	isso
that much	tanto
that, which, which one, who	quem
the	a
the	as
the	o
the	o
the	os
the day before yesterday	anteontem
theater	teatro
theatre	teatro
theft	roubo
theirs	dele
them, they	eles
theme	tema
then	então
theory	teoria
therapy	terapia
there is, there are	há
there, yonder	acolá
there, yonder	ali
there, yonder	aí
there, yonder	lá
thereafter	depois disso
thermometer	termômetro
thermostat	termostato
these	estes
thick	densamente
thickness	espessura
thief	ladrão
thigh	coxa
thimble	dedal
thin	fino
thing	coisa
thing	cousa
things	coisas
think	pense
think, thinking	pensar
third	terceiro
thirst	sede
thirteen	treze
thirty	trinta
this	isso
this	isto
thorn	espinho
those	aqueles
thou, you	tu
thought	pensamento
thoughtful	pensativo
thousand	mil
threaten	ameace
three	três
threshold	ponto inicial
throat, canyon, neck	garganta
through	através
throughout	durante todo
throw	atirar
throw	lançar
thrust	pressão
thumb	polegar
thunder	trovão
Thursday	Quinta-feira
Tibetan	Tibetano
tick	tiquetaque
ticket, gateway, pass, passage	passagem
ticket-window	bilhete-janela
tickle	cócegas
tide	maré
tidy	arrumado
tie, necktie	gravata
tiger	tigre
tighten	aperte
timber	madeira
timber, wood	madeira
time	tempo
times	tempos
timeshare	habitação periódica
timetable	agenda
tin	estanho
tint	cor
tint	matiz
tint	matiz
tint	tinta
tinted	pintado
tinted	tingido
tintless	sem cor
tinware	artigos de folhas de estanho
tiny	delgado
tiny	diminuto
tiny	minúsculo
tip	bico
tip	declive
tip	dica
tip	extremidade
tip	gorjeta
tip	inclinação
tip	palpite
tip	ponta
tip	ponta do pé
tipple	bebericar
tipple	embriagar-se
tiptoe	ponta
tirade	discurso longo
tirade	invectiva
tirades	plural de tirade
tire	aro
tire	pneu
tire	roda
tire	virola
tired	cansado
tired	fatigado
to, toward, towards	a
toad	sapo
toast	brinde
tobacco	tabaco
tobacconist's	tobacconist
today	hoje
today, to-day	hoje
toe	dedo do pé
together	junto
toilet	privada
toilet	retrete
toilet	toalete
toilet-paper	toalete-papel
tolerate	tolere
tolling	anunciar
tomato	tomate
tomato-soup	tomate-sopa
tomb	túmulo
tombstone	lápide
tomorrow	amanhã
ton	tonelada
tone	tom
tongs	alicate
tongue	lingua
tonight	hoje à noite
too	demasiado
tooth	dente
topic, topical	tópico
torch	tocha
torn	rasgado
tortoise	tartaruga
torture	tortura
toss	lance
touch, touching	toque
tourist	turista
tow, trailer, tug	reboque
towel	toalha
towing-line	reboque-linha
town-hall	cidade-salão
toy	brinquedo
trace, trait	traço
track	trilha
tractor	trator
trading	negociar
tradition	tradição
traditional	tradicional
traffic	tráfego
tragedy	tragédia
tragic	trágico
trail	fuga
train	comboio
train	trem
tramping	vagar
transaction	transação
transfer	transferência
transform	transforme
translate	traduza
translation	tradução
transmit	transmita
transport, haul	transporte
transverse	transversal
trap	armadilha
traveler, traveller	viajante
treacherous	traiçoeiro
tread	passo
treasure	tesouro
treat	deleite
treatment	tratamento
treaty	tratado
tree	árvore
tree-trunk	árvore-tronco
tremble	trema
trench	trincheira
trial	experimentação
triangle	triângulo
tribute	tributo
trick	truque
tricycle	triciclo
trigger	disparador
trim	guarnição
trip	desengate
triple	triplicar-se
triumph	triunfo
trolley	trole
troop	tropa
trot	trote
trough	calha
trout	truta
truck	caminhão
true	verdadeiro
trumpet	trombeta
truncate	truncado
trunk	baú
truth	verdade
tube	tubo
tube, valve	válvula
Tuesday	Terça-feira
tuft	topete
tug, tugboat	rebocador
tuna, tuna-fish, tunny	atum
tuna-fish	atum-peixes
Tunis	Tunes
Tunisia	Tunísia
tunnel	túnel
tunny	atuns
Turk	turco
turkey	peru
Turkey	Turquia
turnip	nabo
Tuscany	Toscânia
TV	Tevê
Twelfth-night	Décimo-noite
twelve	doze
twenty	vinte
twenty-one	vinte e um
twice	duas vezes
twig	galho
twilight	crepúsculo
twins	gémeos
twins	gêmeos
twist	torção
two	dois
two	duas
type	tipo
typewriter	máquina de escrever
typical	típico
typist	datilógrafo
tyre	pneumático
ugly	feio
Ukraine	Ucrânia
umbrella	guarda-chuva
unanimous	unânime
uncle	tio
unconscious	inconsciente
uncouple	desacople
underground	subterrâneo
underneath	debaixo de
understandable	compreensível
understanding	compreensão
undertake	empreenda
underwater	subaquático
undoubtedly	indubitàvelmente
unemployed	desempregados
unemployment	desemprego
unexpectedly	inesperada
unfortunate, unhappy	infeliz
unfortunately	desgraçadamente
unfortunately	infelizmente
unhook	desenganche
uniform	farda
uniform	uniforme
unimportant	sem importância
unintentional	involuntário
unit, unity	unidade
unite	una
united	unido
universe	universo
university	universidade
unless	a menos que
unload	descarregue
unlock	destrave
unmarried	solteiro
unoccupied	desocupado
unpack	desembale
unseen	despercebido
unsound	doentio
untie	desate
unusual	incomun
up	acima de
upon	em cima
upset	virada
upwards	para cima
uranium	urânio
urban	urbano
urge	impuso
urgent, urgently	urgente
Uruguay	Uruguai
us, we	nós
USA	EUA
use	uso
used	usado
useless	inútil
USSR	URSS
utility	utilidade
utopian	utópico
vacant	vago
vacation	férias
vaccine	vacina
vacuum cleaner	aspirador
vacuum-cleaner	vácuo-líquido de limpeza
vain	vão
valid	válido
validate	valide
valley	vale
valuable	valioso
value, worth	valor
van	camionete
vandal	vândalo
variable	variável
varied	variado
variety	variedade
various	vário
varnish	verniz
vary	varie
vase	vaso
vast	vasto
Vatican, the Vatican	Vaticano
vegetable	legume
vegetable	vegetal
vegetarian	vegetariano
vegetation	vegetação
vehicle	veículo
veil	véu
vein	veia
velvet	veludo
Venice	Veneza
verb	verbo
verse	verso
version	versão
vessel	embarcação
vest, waistcoat, collect	colete
vibrate	vibre
vice-president	vice-presidente
victim	vítima
victory, win	vitória
videotape	videocassette
Vienna	Viena
view, clothe, sight	vista
village	aldeia
vine	vinha
vine, grapevine	videira
vinegar	vinagre
vineyard	vinhedo
violence	violência
violently	violentamente
violet	violeta
violin	violino
viper	cobra
viper	víbora
virgin	virgem
virus	vírus
visa	visto
visible	visível
vision	visão
visit	visita
visitor	visitante
vitamin	vitamina
vocabulary	vocabulário
volcano	vulcão
voluntarily	voluntàriamente
voluntary, volunteer	voluntário
vomit	vómito
vote, vow	voto
vowel	vogal
wages	salários
wail	lamento
waist	cintura
wait	espera
waiter	criado
waiter	empregado de mesa
waiter	garçon
waiting-room	waiting-quarto
wake	vigília
Wales	Gales
walk	caminhada
wall	muro
wall	parede
wall-painting	parede-pintura
wall-tile	parede-telha
wallet	carteira
walnut-tree	nogueira
walnut-tree	noz-árvore
want	queira
war	guerra
warehouse	armazém
warn	advirta
warning	aviso
Warsaw	Varsóvia
wash	lavagem
wash	lavar
washroom	banheiro
wasp	vespa
waste	desperdício
wasted	desperdiçado
watch, wrist-watch	relógio
watchmaker	relojeiro
watchman	guarda
water, water-	água
water-bottle	água-frasco
water-buffalo	água-búfalo
water-closet	água-armário
water-colour	água-cor
water-melon	melancia
waterfall	cachoeira
waterfall	cascata
wave, curl	onda
wax	cera
weaken	enfraqueça-se
weakly	fraca
wealth	riqueza
weapon	arma
wear	calçar
wear	desgaste
weary	cansado
weather, time	tempo
weaver-bird	weaver-pássaro
wedding	casamento
wedding-party	casamento-partido
wedge	cunha
Wednesday	Quarta-feira
weed	erva daninha
week	semana
week-end	fim de semana
weekly	semanal
weekly	semanalmente
weigh	pese
weight	peso
welcome	boa vinda
welder	soldador
well-being	bem estar
Welsh	Galês
west, West	oeste
west, western	ocidental
wet	molhado
whale	baleia
what	que
what time is it?	que horas são?
what?	que?
whatever	o que quer que
wheat	trigo
wheat	trigo
wheel	roda
when, while	quando
when?	quando?
where	aonde
where	onde
where ... to	aonde
where?	onde?
wherever	onde quer que
which	qual
whip	chicote
whirl	giro
whisper	sussurro
whistle	assobiar
whistle	assobie
who?	quem?
wholesale	venda por atacado
whose	de quem
whose?	de quem?
why?	por que?
wick	feltro de lubrificação
wide	largamente
widow	viúva
widower	viúvo
width	largura
wife	esposa
wife, woman	mulher
wildebeest	mais wildebeest
will	vontade
willingly	disposta
willingly	voluntariamente
willingness	voluntariedade
willow	salgueiro
wind	vento
wind-instrument	vento-instrumento
window	a janela
window	janela
window, ticket-window	bilheteira
window, ticket-window	bilheteria
window-frame	janela-frame
window-glass	janela-vidro
windowless	sem janelas
windowpane	o vidro
windowpanes	os vidros
windows	as janelas
wine	o vinho
wine	vinho
wineglass	a taçã
wing	a asa
wing	asa
winged	voado
winter	inverno
wire	arame
wisdom	sabedoria
wit	sagacidade
witch	bruxa
with	com
withdraw	retire
within	dentro
without	sem
witness	testemunha
wolf	lobo
woman-chaser	mulher-caçador
wonderful	maravilhoso
woodpecker	fuinho
woods	madeiras
wool	lã
wool	lãs
word	palavra
word, say	palavra
work	trabalhar
work-basket	trabalh-cesta
workbench	bancada
worker, workman	trabalhador
works	trabalhos
workshop	oficina
world	mundo
worm	bicho
worm	sem-fim
worm-eaten	sem-fim-comido
worn	desgastado
worries	preocupa-se
worry	preocupação
worship	adoração
wrapper	envoltório
wrapping-paper	wrapping-papel
wreath	grinalda
wreathe	entreteça
wren	carriça
wrest	mais wrest
wrinkle	enrugamento
wrist, pulse	pulso
wrist-watch	relógio de pulso
write	escreva
write	escrever
writer	escritor
writing	escrita
writing-desk	escrita-mesa
writing-paper	escrita-papel
written	escrito
X-rays	Raios X
xerographic	xerográfico
xerography	xerografia
yard	jarda
yawn	bocejo
year	ano
yearly	anualmente
yearn	ansíe
yeast	fermento
yellow	amarelo
Yes	Sim
yes	sim
yesterday	ontem
yesterday	ontem
yet	ainda
yield	produzir
yield	render
yield	rendimento
yogurt	iogurte
yoke	canga
yoke	jugo
yolk	gema de ovo
yonder	acolá
yonder	alí
yonder	Lá
you	Tu
you	você
you	você
young	jovem
young	novo
young, youngster	jovem
youngish	Algo
youngness	juventude
youngness	mocidade
youngster	jovem
youngster	mancebo
youngster	moço
youngster	rapaz
youngsters	jovens
youngsters	mancebos
youngsters	moços
youngsters	rapazes
your	teu
your	teus
your	tua
your	tuas
yours	a tua
yours	as tuas
yours	o teu
yours	os teus
yourself	te
yourself	tu mesmo
yourself	você mesmo
yourselves	voces mesmos
youth	juventude
youth	um jovem
youth	um moço
yowl	uivo
Yugoslav, Yugoslavian	Jugoslavo
Yugoslavia	Jugoslávia
Zambia	Zâmbia
zinc	zinco
zone	zona
zoo	jardim zoológico
