a lot of, much	ingi
a, in, inside, into, per, within	katika
a, in, inside, into, per, within	ndani ya
aberration, error, mistake	kosa
able, capable	enye akili
above, on top, overhead, upstairs	juu
abrasive, lurid, sharp, hot	kali
abroad	ugenini
abroad, out, outside	nje
absent	hako
absolute, complete	kamili
Abyssinia, Ethiopia	Habeshi
accede, agree, consent	kubali
accept, receive, take, take in	pokea
accident	tukio baya
accompany	kwenda na
account, number, numeral	hesabu
across from, against, in exchange for, opposed to	juu ya
action	tendo
actor	mcheza
ad, advertisement	tangazo
address	anwani
adieu, farewell, bye, goodbye, good-bye	kwa heri
adieu, farewell, bye, goodbye, good-bye	kwa herini
ado, din, noise	kelele
advice, counsel, design, diagram, plan, plane	shauri
affair, business, business deal, case, matter	jambo
after	baada ya
afternoon	alasiri
again, all over again, anew, once more	tena
age	umri
ahead, formerly, previously, foreward	mbele
air	hewa
ale, beer	pombe
alien, foreign, strange	a kigeni
all of a sudden, suddenly	ghafula
all, each, every, everyone	kila
all, each, every, everyone	ote
also, too, equally	pia
always	sikuzote
American, US citizen	mwamerikani
among, between	kati ya
and	na
angel	malaika
animal, beast	mnyama
answer, reply	jibu
antelope	paa
ape, monkey	tumbili
appellation, name	jina
apple	tunda la kizungu
April	Aprili
Arab	Mwarabu
Arabia	Uarabu
Arabia	Ulaya wa Waarabu
arm, hand	mkono
article of clothing, garment, clothes	nguo
ass, donkey	punda
at all, entirely, wholly	kabisa
at all, ever	o -ote
at once, right away, right now	sasa hivi
at present, now	sasa
axe	shoka
baboon	nyani
bad, miserable, nasty, poor	baya
bad, rotten	bovu
badly	vibaya
bag, sack	gunia
bag, sack	mfuko
banana	ndizi
banana plant, banana-plant	mgomba
bank	benki
bark, husk, peel, shell	ganda
basket	kikapu
bazaar, fair, market, marketplace	soko
bear	dubu
beard	ndevu
beautiful, fine, handsome, lovely, good, nice	zuri
because, for the reason that, since	kwa sababu
bed	kitanda
bee	nyuki
before, in front of	kabla ya
before, in front of	mbele ya
behind	nyuma
behind, after	nyuma ya
below, beneath, under	chini ya
below, downstairs, underneath	chini
Bible	Biblia
big, great, large, important, serious	kubwa
bike, cycle, bicycle	baisikeli
bird	ndege
bird	nyuni
bitter	chungu
black	eusi
blackness	weusi
blank, white	eupe
blind, sightless person	kipofu
blood	damu
bloom, flower, court, yard, courtyard	ua
board, plank	ubao
body	mwili
bold, corpulent, fat, thick	nene
bold, corpulent, fat, thick	nono
bone	mfupa
book	kitabu
bosom, breast, chest	kifua
boss, chief, leader	jumbe
boss, master	bwana
bottle	chupa
boutique, shop, store	duka
bovine, bovine animal	ng'ombe
box	sanduku
boy, servant	mtumishi
brave, courageous, valiant	hodari
bread, loaf	mkate
broad	pana
broom	ufagio
brother	kaka
brother, relative	ndugu
buffalo	nyati
bug, insect	mdudu
bull	ng'ombe dume
burden, charge, load	mzigo
burdensome, heavy, onerous	zito
bureau, office	afisi
but, however, nevertheless, yet	bali
but, however, nevertheless, yet	lakini
butter	siagi
cabin, hut, shack	kibanda
camel	ngamia
carpenter	seremala
cassava, cassave	muhogo
cat	paka
centipede	tandu
certificate, testimony	cheti
chair	kiti
chamber, room	chumba
cheese	jibini
chicken, fowl	kuku
chief, main, major, principal	kuu
child, infant	mtoto
Christian	Mkristo
church, kirk	kanisa
city, town, village	mji
clean, pure	safi
clerk	karani
clever, cunning, sly, smart	erevu
clock, watch, hour, o'clock, time	saa
cloth	kitambaa
coast, seaside, shore	pwani
cock, rooster	jogoo
cocoanut, cocoa-nut, coconut, coco-nut	dafu
cocoanut, cocoa-nut, coconut, coco-nut	nazi
coconut palm, coconut-palm	mnazi
coffee	kahawa
cold	baridi
colour, dye	rangi
cook, male cook	mpishi
cooking pot, jug	chungu
cord, rope, string	uzi
cork	kizibo
corn, Indian corn, maize, mealies	muhindi
correct, right	sahihi
country, land	nchi
country, land	ulaya
course, dish, platter	sahani
cover, hood, lid	kifuniko
crab	kaa ya pwani
crocodile	mamba
cross	msalaba
cup	kikombe
currently, nowadays, these days	siku hizi
custom, habit, way	desturi
danger, peril	hatari
dark, dim	enye giza
darkness, murk	giza
date	tarehe
date palm, date-palm	mtende
daughter	binti
day	siku
dear, expensive, lovely, valuable, costly, pricey	ghali
December	Desemba
diminutive, little, small	dogo
disease, illness	ugonjwa
dismal, gaunt, miserable, sad	a huzuni
distance, offset, journey, trip, voyage	mwendo
doctor, physician	daktari
doctor, physician	mganga
dog	mbwa
dream	ndoto
drug, medicine, pharmaceutical	dawa
dry	kavu
dung, excrement, latrine	choo
ear	sikio
early	mapema
earth, land, soil	kiwanja
east, East	mashariki
Easter	Pasaka
easy, facile, cheap, inexpensive	rahisi
egg	yai
Egypt	Misri
eighteen	kumi na -nane
eighteen	kumi na nane
eighth	a nane
eighty	themanini
elephant	ndovu
elephant	tembo
eleven	edashara
eleven	kumi na -moja
eleven	kumi na moja
empty, void	tupu
enchanter, magician, sorcerer, warlock, wizard	mchawi
enchantment, magic, sorcery, witchcraft, wizardry	uchawi
end, ending	mwisho
enemy	adui
engine, machine	mashine
engine, machine	mtambo
England	Uingereza
England	Ulaya wa Waingereza
Englishman, Sassenach	Mwingereza
enough, sufficient	a kutosha
entire, overall, whole	zima
Europe	Ulaya
European	Mzungu
evening	jioni
exclusively, just, only, alone, solely	tu
eye	jicho
face	uso
factory	karakana
factory	kiwanda
faint, light, weak, miserable, poor	hafifu
father	baba
fear	hofu
February	Februari
fellow, man	mwanamume
fever	homa
field	shamba
fifteen	kumi na -tano
fifteen	kumi na tano
fifth	a tano
fifty	hamsini
fine, great, eminent	bora
finger, toe	kidole
finished, ready, through	tayari
fire	moto
first	a kwanza
fish	kuvua
fish	samaki
flour, meal	unga
fly, housefly	inzi
folk, nation, people	watu
food	chakula
fool	mjinga
for, to, in order to	ili
foreigner, stranger, guest	mgeni
forest, woods	msitu
forgetful	sahaulifu
forty	arobaini
fourteen	kumi na -nne
fourteen	kumi na nne
fourth	a nne
fragment, lump, piece, part, share, spare part	kipande
France	Ufaransa
France	Ulaya Faransa
Frenchman	Mfaransa
frequently, often, regularly	mara nyingi
Friday	Ijumaa
friend	rafiki
frog	chura
from, out of	kwa
gain, profit	faida
game	mchezo
garage	banda la motokaa
garden	bustani
gate, gateway, portal, door	mlango
gazette, magazine, newspaper, periodical	gazeti
gentle, soft, sweet, tender	tamu
German	mdachi
German	mjeremani
Germany	Udachi
Germany	Ujeremani
giraffe	twiga
gladness, joy	furaha
gnu, wildebeest	kongoni
gnu, wildebeest	nyumbu
goat	mbuzi
God	Allah
God	Mungu
good, nice, okay	ema
grass	majani
Greek	Myunani
greeting	salamu
ground, soil	udongo
guard	mlinzi
hair	nywele
hard	gumu
hare	sungura
harvest	mavuno
have, have got	na
he, him	yeye
head, pate	kichwa
health	afya
heart	moyo
Hebrew, Jew	Myahudi
Hebrew, Jew	Yahudi
help, aid	msaada
here	hapa
here	huku
here	humu
hey, say, now, well, well then	je
hill	kilima
hill, mountain	mlima
hippo, hippopotamus	kiboko
hoe	jembe
hole	tundu
honey	asali
horse	farasi
hot	a moto
hotel	hoteli
house	nyumba
how many?, how much?	ngapi?
how?, in what way?	je?
how?, in what way?	namna gani?
hundred, one hundred	mia
hunger	njaa
husband	mume
hyaena, hyena	fisi
I, me	mimi
if, provided that	ikiwa
ill, sick	gonjwa
India	Bara Hindi
India	Uhindi
Indian	Mhindi
inhabitant	mwenyeji
ink	wino
inside	ndani
instead of	badala ya
instructor, teacher	mwalimu
iron	chuma
island	kisiwa
jackal	mbweha
January	Januari
job, work	kazi
journey, trip, voyage	safari
jug, box, container, vessel, vase	chombo
July	Julai
June	Juni
Kenya	Kenya
key, wrench	ufunguo
kilo	kilo
kilometer, kilometre	kilometa
king	mfalme
kingdom	ufalme
knee	goti
knife	kisu
Koran	Msahafu
lamp	taa
language, tongue	lugha
last	a mwisho
laziness	uvivu
lazy	vivu
leaf, sheet	jani
leg, paw, foot	mguu
length	urefu
leopard	chui
letter	barua
lie	uongo
life	maisha
light	nuru
light, fast, quick, rapid, speedy, swift	epesi
lightning	umeme
line	mstari
lion	simba
long, deep, profound	refu
loss	hasara
Lucifer, Satan	Ibilisi
mango	embe
mango tree, mango-tree	mwembe
March	Machi
mat, plaited mat	mkeka
mature, ripe	bivu
May	Mei
maybe, perhaps, possibly	labda
meaning	maana
measure, measurement, grade, rank, rate	cheo
meat	nyama
midday, noon	adhuhuri
milk	maziwa
millet	mtama
minute	dakika
mirror, glass	kioo
miserable, poor	maskini
Mohammedan, Moslem, Muslim, Mussulman	Mwislamu
Monday	Jumatatu
moon, month	mwezi
Moscow	Misko
mosquito	mbu
mother	mama
mouse	panya mdogo
my	angu
narrow, slender, slim	embamba
nearby	karibu
necessary	lazima
need	haja
needle	sindano
net, network	wavu
new, novel	pya
newness	upya
news, novelty, something new	habari
night	usiku
nine	kenda
nine	tisa
nineteen	kumi na kenda
nineteen	kumi na tisa
ninety	tisini
ninth	a kenda
ninth	a tisa
no, not	la
north, North	kaskazini
not at all	hata kidogo
November	Novemba
now and then	mara kwa mara
nurse	mlezi
occasion, time	mara
October	Oktoba
oil	mafuta
OK, okay, well	vema
OK, okay, well	vizuri
once, one time	mara moja
one	mosi
onion	kitunguu
or	au
orange	chungwa
orange tree, orange-tree	mchungwa
other, another, else	ingine
our	etu
owner	mwenyewe
palace	jumba
paper	karatasi
parent	mzazi
part, piece, share	sehemu
path, road, route, way	njia
patient	mgonjwa
pawn, soldier	askari
pencil, feather	kalamu
permission	ruhusa
Persia	Uajemi
person	mtu
pig	nguruwe
pipe	kiko
place, plaza, square, public square	mahali
please	tafadhali
Portugal	Ureno
Portuguese	Mreno
potato	kiazi
poverty	umaskini
progress	maendeleo
question	swali
quite, very, very much	sana
quite, very, very much, too, too much	mno
rabbit	kisungura
rain	mvua
Rajab	Rajabu
Ramadan	Ramadhani
rat	panya
rather, across, on the other side of	katikati
razor	wembe
reason	sababu
red	ekundu
Red Sea	Bahari ya Sham
respect	heshima
restaurant	mkahawa
rhino, rhinoceros	kifaru
rib	ubavu
rice	mpunga
rice, husked rice	mchele
rich, wealthy, well-off	tajiri
right, righthand	a kuume
river	mto
road, route, way	barbara
Roman	Mrumi
root	mzizi
sadness, sorrow	huzuni
salary, wage, wages	mshahara
salt	chumvi
school	chuo
school	shule
scorpion	nge
sea	bahari
second	a pili
seed	mbegu
self, herself, himself, itself	enyewe
September	Septemba
serpent, snake	nyoka
seven	saba
seventeen	kumi na saba
seventh	a saba
seventy	sabini
several times, sometimes	pengine
Sha'ban	Shaabani
sharpness	ukali
sheep	kondoo
shepherd	mchungaji
shoe	kiatu
shopkeeper	mwuza duka
short, brief	fupi
silver, money	fedha
sister	dada
six	sita
sixteen	kumi na sita
sixth	a sita
sixty	sitini
size	ukubwa
slave	mtumwa
sleep	usingizi
smallpox	ndui
smoke	moshi
smooth, soft	laini
soap	sabuni
son, child, offspring, young	mwana
song	wimbo
south	kusini
spider	buibui
spoon	kijiko
spoon, large spoon	mwiko
stomach	tumbo
stone	jiwe
stream	kijito
strong	enye nguvu
strong	imara
suffice	tosha
sugar	sukari
sugar-cane	muwa
sun	jua
Sunday	Jumapili
sweetness	utamu
Syria	Sham
table	meza
tail	mkia
Tanzania	Tanzania
tea	chai
ten	kumi
tenth	a kumi
thank you, thanks	asante
that, as, how, like, such as, if, provided that	kama
that, which, which one, who	nani
the day after tomorrow	kesho kutwa
the day before yesterday	juzi
their, her, his, its	ao
their, his, her, its	ake
them, they	wao
there, yonder	kule
there, yonder	mle
there, yonder	pale
therefore	kwa hiyo
thief	mwivi
thief	mwizi
thing, article, object	kitu
third	a tatu
thirteen	kumi na -tatu
thirteen	kumi na tatu
thirty	thelathini
thorn	mwiba
thou, you	wewe
though, although	ingawa
thought	wazo
thousand, one thousand	elfu
Thursday	Alhamisi
time	nafasi
time	wakati
tin-opener	kifungua kopo
tobacco	tumbako
today, to-day	leo
together	pamoja
tomato	nyanya
tomorrow	kesho
tongue	ulimi
tooth	jino
tooth-brush	mswaki
tortoise	kobe
traveler, traveller	msafiri
tree, pole, post, stanchion, stake, timber, wood	mti
tribe	kabila
Tuesday	Jumanne
twelve	kumi na -wili
twelve	kumi na mbili
twelve	thenashara
twenty	ishirini
two	mbili
two	pili
two	wili
two hundred	mia -wili
two hundred	mia mbili
Uganda	Uganda
ulcer, sore	kidonda
umbrella	mwavuli
uncle	baba mdogo
uncle	mjomba
United States of America, USA	Ulaya wa Waamerikani
unity	umoja
university	chuo kikuu
unripe	bichi
until	hata
us, we	sisi
vegetable	mboga
village	kijiji
volcano	volkeno
wall	ukuta
water	maji
wax	nta
Wednesday	Jumatano
week	juma
week	wiki
well	kisima
well	shimo
west, West	magharibi
what	nini
what kind of, what sort of	gani
what kind of?	gani?
what?	nini?
wheat	ngano
when	lini
when?	lini?
where	wapi
where?	wapi?
wherever	mahali po pote
who?	nani?
who?	pi?
widow	mjane
wife	mke
wind	upepo
wing	ubawa
wisdom	ujinga
without	bila
without	pasipo
woman	mwanamke
word	neno
world	ulimwengu
year	mwaka
yes	naam
yes	ndiyo
yesterday	jana
you	ninyi
youngster, youth	kijana
your	ako
your	enu
Zanzibar	Unguja
zebra	punda milia
